"player","nation","pos","team","played_90s","tackles","tackles_won","tackles_def_3rd","tackles_mid_3rd","tackles_att_3rd","drib_tackles","drib_tackles_att","tackles_lost","blocks","blocks_shot","blocks_pass","interceptions","clearances","errors"
"Max Aarons","ENG","DF","Bournemouth","1.0","2","2","1","1","0","1","1","0","3","1","2","1","0","0"
"Joshua Acheampong","ENG","DF","Chelsea","1.9","2","1","2","0","0","2","2","0","1","0","1","1","2","0"
"Tyler Adams","USA","MF","Bournemouth","21.8","83","50","26","49","8","39","72","33","33","10","23","32","42","0"
"Tosin Adarabioyo","ENG","DF","Chelsea","15.7","17","13","11","6","0","8","12","4","9","7","2","11","80","0"
"Simon Adingra","CIV","FW,MF","Brighton","12.2","23","14","10","8","5","10","26","16","12","0","12","8","6","2"
"Emmanuel Agbadou","CIV","DF","Wolves","15.7","30","19","21","9","0","13","20","7","19","13","6","12","90","0"
"Asher Agbinone","ENG","MF","Crystal Palace","0.1","2","1","0","2","0","0","0","0","0","0","0","0","0","0"
"Ola Aina","NGA","DF","Nott'ham Forest","33.3","55","42","39","15","1","36","64","28","34","12","22","33","115","4"
"Rayan Aït-Nouri","ALG","DF","Wolves","34.5","89","57","52","28","9","43","70","27","42","6","36","26","75","2"
"Kristoffer Ajer","NOR","DF","Brentford","16.0","26","18","14","11","1","14","27","13","17","4","13","12","50","0"
"Manuel Akanji","SUI","DF","Manchester City","22.4","19","12","12","4","3","11","17","6","11","8","3","9","64","3"
"Nathan Aké","NED","DF","Manchester City","7.5","9","7","7","2","0","4","6","2","7","2","5","3","22","1"
"Carlos Alcaraz","ARG","MF","Southampton","0.1","0","0","0","0","0","0","0","0","0","0","0","1","0","0"
"Carlos Alcaraz","ARG","FW,MF","Everton","8.5","11","5","5","3","3","3","11","8","9","2","7","5","10","0"
"Trent Alexander-Arnold","ENG","DF","Liverpool","26.3","72","50","44","19","9","49","105","56","26","9","17","31","55","4"
"Alisson","BRA","GK","Liverpool","27.9","1","0","1","0","0","0","1","1","0","0","0","0","13","1"
"Miguel Almirón","PAR","FW","Newcastle Utd","1.7","3","2","2","0","1","2","3","1","2","0","2","0","0","0"
"Olabade Aluko",NA,"DF","Leicester City","0.0","1","1","0","0","1","1","1","0","0","0","0","0","0","0"
"Edson Álvarez","MEX","MF","West Ham","19.7","50","27","27","15","8","17","35","18","23","8","15","18","46","1"
"Will Alves","ENG","FW","Leicester City","0.0","0","0","0","0","0","0","0","0","0","0","0","0","0","0"
"Harry Amass","ENG","DF","Manchester Utd","3.8","6","2","5","1","0","2","8","6","11","1","10","2","11","0"
"Samuel Amo-Ameyaw","ENG","FW,DF","Southampton","0.3","1","0","0","1","0","1","1","0","0","0","0","0","0","0"
"Mathis Amougou","FRA","MF","Chelsea","0.1","0","0","0","0","0","0","0","0","0","0","0","0","0","0"
"Joachim Andersen","DEN","DF","Crystal Palace","1.0","1","1","1","0","0","1","2","1","0","0","0","0","7","0"
"Joachim Andersen","DEN","DF","Fulham","28.7","27","18","20","6","1","15","24","9","37","28","9","34","188","1"
"Elliot Anderson","ENG","MF","Nott'ham Forest","30.3","92","56","54","29","9","48","111","63","48","9","39","31","76","4"
"André","BRA","MF","Wolves","27.5","91","55","41","41","9","37","63","26","42","8","34","37","30","1"
"Michail Antonio","JAM","FW","West Ham","9.3","2","2","0","1","1","2","3","1","6","0","6","0","2","0"
"Antony","BRA","DF,MF","Manchester Utd","1.6","6","3","4","2","0","2","5","3","2","0","2","2","0","0"
"Julian Araujo","MEX","DF","Bournemouth","5.5","10","5","4","6","0","5","12","7","3","0","3","6","18","0"
"Cameron Archer","ENG","FW","Southampton","16.0","13","8","8","3","2","2","9","7","5","1","4","2","11","0"
"Alphonse Areola","FRA","GK","West Ham","25.1","2","2","2","0","0","2","3","1","0","0","0","0","15","3"
"Joe Aribo","NGA","MF,DF","Southampton","22.4","47","33","17","24","6","17","35","18","28","11","17","20","32","3"
"Adam Armstrong","ENG","FW,MF","Southampton","13.9","12","3","2","7","3","3","14","11","6","1","5","3","8","0"
"Harrison Armstrong","ENG","MF","Everton","0.5","0","0","0","0","0","0","1","1","0","0","0","0","1","0"
"Kepa Arrizabalaga","ESP","GK","Bournemouth","31.0","1","0","1","0","0","0","2","2","2","0","2","0","15","3"
"Marco Asensio","ESP","MF","Aston Villa","8.3","7","5","0","7","0","3","9","6","7","1","6","2","3","0"
"Brandon Austin","ENG","GK","Tottenham","1.0","0","0","0","0","0","0","0","0","0","0","0","0","1","0"
"Taiwo Awoniyi","NGA","FW","Nott'ham Forest","4.6","6","3","0","3","3","4","5","1","1","0","1","0","7","0"
"Yasin Ayari","SWE","MF","Brighton","21.8","59","32","15","31","13","26","56","30","24","6","18","20","26","0"
"Jordan Ayew","GHA","FW,MF","Crystal Palace","0.2","1","0","0","0","1","0","0","0","0","0","0","0","0","0"
"Jordan Ayew","GHA","FW,MF","Leicester City","18.2","27","15","8","14","5","7","23","16","21","2","19","12","19","0"
"Benoît Badiashile","FRA","DF","Chelsea","3.7","9","6","5","4","0","4","5","1","2","2","0","6","12","2"
"Leon Bailey","JAM","FW,MF","Aston Villa","12.7","7","5","2","3","2","3","11","8","6","0","6","3","12","0"
"Carlos Baleba","CMR","MF","Brighton","29.6","79","46","26","37","16","48","80","32","47","11","36","46","44","1"
"Ross Barkley","ENG","MF","Aston Villa","6.5","14","3","4","10","0","9","14","5","9","3","6","10","5","0"
"Harvey Barnes","ENG","FW","Newcastle Utd","19.5","16","9","4","6","6","3","11","8","8","2","6","6","15","1"
"Calvin Bassey","NGA","DF","Fulham","34.2","54","34","35","19","0","22","31","9","40","17","23","20","118","8"
"Altay Bayındır","TUR","GK","Manchester Utd","4.0","0","0","0","0","0","0","1","1","0","0","0","0","9","1"
"Jan Bednarek","POL","DF","Southampton","28.1","36","19","23","13","0","16","31","15","47","36","11","56","190","5"
"Armel Bella Kotchap","GER","DF","Southampton","3.7","7","5","5","2","0","3","6","3","2","2","0","5","21","1"
"Jean-Ricner Bellegarde","FRA","MF,FW","Wolves","18.6","39","24","17","19","3","14","20","6","19","3","16","10","18","1"
"Rodrigo Bentancur","URU","MF","Tottenham","18.3","40","22","19","17","4","19","40","21","25","8","17","40","38","1"
"Daniel Bentley","ENG","GK","Wolves","2.0","0","0","0","0","0","0","0","0","0","0","0","0","1","0"
"Sander Berge","NOR","MF","Fulham","24.7","50","30","23","23","4","27","39","12","27","8","19","21","38","1"
"Lucas Bergvall","SWE","MF","Tottenham","13.5","39","19","14","20","5","17","32","15","18","8","10","24","22","3"
"Victor Bernth Kristiansen","DEN","DF","Leicester City","27.6","87","51","56","26","5","49","91","42","38","15","23","42","75","3"
"Beto","GNB","FW","Everton","17.0","14","6","2","8","4","5","8","3","12","2","10","4","24","1"
"Philip Billing","DEN","MF","Bournemouth","2.0","14","5","7","6","1","3","4","1","3","0","3","5","2","0"
"Yves Bissouma","MLI","MF","Tottenham","15.6","49","31","20","25","4","19","34","15","11","6","5","18","40","4"
"Oscar Bobb","NOR","FW","Manchester City","0.2","0","0","0","0","0","0","0","0","0","0","0","0","0","0"
"Lamare Bogarde","NED","DF,MF","Aston Villa","5.3","14","6","6","6","2","10","16","6","5","3","2","1","13","0"
"Willy Boly","CIV","DF","Nott'ham Forest","1.7","6","1","5","1","0","4","4","0","4","2","2","3","12","0"
"Sven Botman","NED","DF","Newcastle Utd","4.6","12","9","6","5","1","7","9","2","5","4","1","5","25","1"
"Jarrod Bowen","ENG","FW,MF","West Ham","33.0","41","26","13","12","16","19","40","21","22","4","18","16","25","0"
"Conor Bradley","NIR","DF","Liverpool","8.4","14","10","7","5","2","11","22","11","9","2","7","4","31","0"
"Jarrad Branthwaite","ENG","DF","Everton","27.9","36","20","26","10","0","20","28","8","31","23","8","27","191","4"
"James Bree","ENG","DF","Southampton","11.9","19","14","8","10","1","10","25","15","10","3","7","9","29","0"
"Ben Brereton","CHI","FW","Southampton","5.0","3","2","0","2","1","1","9","8","2","1","1","0","4","0"
"Nathan Broadhead","WAL","MF,FW","Ipswich Town","7.8","9","4","3","6","0","3","12","9","8","1","7","4","5","0"
"Armando Broja","ALB","FW","Everton","3.7","3","1","1","1","1","0","0","0","3","0","3","1","4","0"
"David Brooks","WAL","FW,MF","Bournemouth","10.7","14","6","2","8","4","2","16","14","18","2","16","5","9","1"
"Emi Buendía","ARG","MF,FW","Aston Villa","1.1","6","6","3","2","1","0","5","5","5","1","4","0","2","0"
"Santiago Bueno","URU","DF","Wolves","18.7","41","21","22","18","1","17","22","5","36","21","15","15","70","0"
"Facundo Buonanotte","ARG","FW,MF","Leicester City","16.9","53","32","17","22","14","21","67","46","34","6","28","12","14","0"
"Cameron Burgess","AUS","DF","Ipswich Town","17.1","17","12","14","3","0","9","11","2","20","15","5","14","128","3"
"Dan Burn","ENG","DF","Newcastle Utd","37.0","39","24","22","15","2","20","36","16","36","26","10","27","197","4"
"Wes Burns","WAL","FW,DF","Ipswich Town","10.3","13","11","1","9","3","4","10","6","7","2","5","10","13","2"
"Nathan Butler-Oyedeji","ENG","FW","Arsenal","0.1","0","0","0","0","0","0","0","0","0","0","0","0","0","0"
"Moisés Caicedo","ECU","MF,DF","Chelsea","37.2","114","73","44","54","16","54","86","32","49","10","39","49","60","1"
"Tom Cairney","SCO","MF","Fulham","7.0","13","5","5","2","6","4","7","3","7","1","6","4","3","1"
"Jens Cajuste","SWE","MF","Ipswich Town","21.8","44","22","19","23","2","21","49","28","25","10","15","28","33","2"
"Riccardo Calafiori","ITA","DF","Arsenal","10.9","27","19","15","10","2","18","29","11","12","6","6","9","25","0"
"Dominic Calvert-Lewin","ENG","FW","Everton","17.9","9","7","1","4","4","2","6","4","7","2","5","7","23","0"
"Diego Carlos","BRA","DF","Aston Villa","9.2","8","3","6","1","1","4","6","2","13","7","6","5","36","2"
"Fabio Carvalho","POR","FW,MF","Brentford","5.1","13","9","4","4","5","6","13","7","6","1","5","3","2","0"
"Casemiro","BRA","MF","Manchester Utd","16.6","83","50","50","23","10","45","74","29","39","10","29","14","51","3"
"Kaelan Casey","ENG","DF","West Ham","0.0","0","0","0","0","0","0","0","0","0","0","0","0","1","0"
"Matty Cash","POL","DF","Aston Villa","23.0","56","32","29","21","6","31","43","12","22","8","14","23","70","2"
"Eiran Cashin","IRL","DF","Brighton","0.2","0","0","0","0","0","0","1","1","0","0","0","0","2","0"
"Timothy Castagne","BEL","DF","Fulham","18.3","46","29","28","15","3","26","45","19","15","6","9","22","83","0"
"Trevoh Chalobah","ENG","DF","Crystal Palace","11.8","20","16","7","12","1","12","23","11","19","9","10","19","57","3"
"Trevoh Chalobah","ENG","DF","Chelsea","10.1","11","7","5","6","0","7","8","1","6","3","3","10","48","1"
"Conor Chaplin","ENG","MF,FW","Ipswich Town","9.5","15","5","6","6","3","6","14","8","8","1","7","4","3","0"
"Youssef Chermiti","POR","FW,MF","Everton","0.5","0","0","0","0","0","0","1","1","0","0","0","0","0","0"
"Federico Chiesa","ITA","FW","Liverpool","1.2","1","0","0","1","0","0","2","2","1","0","1","0","1","1"
"Ben Chilwell","ENG","DF","Crystal Palace","2.9","7","6","4","3","0","1","5","4","6","2","4","6","16","0"
"Chiquinho","POR","MF","Wolves","0.1","0","0","0","0","0","0","0","0","0","0","0","0","0","0"
"Hamza Choudhury","BAN","MF,DF","Leicester City","1.5","1","1","1","0","0","1","3","2","4","2","2","5","2","0"
"Ryan Christie","SCO","MF","Bournemouth","23.5","54","33","19","27","8","27","64","37","44","11","33","30","51","3"
"Harry Clarke","ENG","DF","Ipswich Town","4.2","5","3","3","2","0","3","6","3","5","4","1","4","14","3"
"Jack Clarke","ENG","FW,MF","Ipswich Town","13.1","32","20","11","10","11","17","34","17","9","0","9","7","29","2"
"Nathaniel Clyne","ENG","DF,MF","Crystal Palace","5.4","12","8","8","3","1","6","11","5","4","2","2","3","14","1"
"Conor Coady","ENG","DF","Leicester City","19.0","13","9","6","6","1","3","6","3","32","24","8","13","71","2"
"Séamus Coleman","IRL","DF","Everton","2.4","3","2","2","1","0","3","4","1","5","3","2","1","8","0"
"Nathan Collins","IRL","DF","Brentford","38.0","40","24","23","12","5","22","36","14","77","57","20","34","226","3"
"Toby Collyer","ENG","MF","Manchester Utd","2.0","12","9","6","6","0","5","6","1","2","1","1","2","3","0"
"Levi Colwill","ENG","DF","Chelsea","35.0","47","34","25","19","3","18","27","9","37","25","12","33","118","4"
"Lewis Cook","ENG","MF,DF","Bournemouth","33.1","81","42","41","36","4","37","67","30","30","11","19","41","70","0"
"Maxwel Cornet","CIV","FW","Southampton","0.8","5","5","1","4","0","0","4","4","0","0","0","0","2","0"
"Vladimír Coufal","CZE","DF","West Ham","11.9","22","15","13","7","2","10","22","12","13","11","2","8","39","1"
"Woyo Coulibaly","MLI","DF","Leicester City","1.2","6","4","4","2","0","2","2","0","3","1","2","5","1","0"
"Aaron Cresswell","ENG","DF","West Ham","9.2","11","7","5","5","1","9","11","2","9","4","5","8","37","0"
"Marc Cucurella","ESP","DF","Chelsea","33.2","67","45","31","31","5","32","61","29","49","16","33","28","95","3"
"Jorge Cuenca","ESP","DF","Fulham","3.9","6","2","5","1","0","3","8","5","4","4","0","2","26","0"
"Matheus Cunha","BRA","MF,FW","Wolves","28.9","38","22","17","16","5","13","39","26","21","1","20","17","23","0"
"Patson Daka","ZAM","FW,MF","Leicester City","8.2","19","10","6","9","4","7","18","11","7","1","6","1","12","0"
"Diogo Dalot","POR","DF","Manchester Utd","31.3","68","40","40","22","6","34","52","18","22","9","13","37","72","0"
"Mikkel Damsgaard","DEN","MF,FW","Brentford","32.3","83","44","27","29","27","31","81","50","40","3","37","27","31","2"
"Danilo","BRA","MF,FW","Nott'ham Forest","3.1","8","4","7","1","0","3","6","3","2","1","1","4","3","0"
"Jayden Danns","ENG","MF","Liverpool","0.1","0","0","0","0","0","0","1","1","0","0","0","0","0","0"
"Kevin Danso","AUT","DF","Tottenham","9.4","7","5","4","3","0","6","11","5","15","14","1","6","71","1"
"Ben Davies","WAL","DF","Tottenham","14.8","17","11","8","8","1","9","17","8","28","19","9","12","81","1"
"Leif Davis","ENG","DF","Ipswich Town","30.5","46","27","33","9","4","30","48","18","25","8","17","25","77","3"
"Craig Dawson","ENG","DF","Wolves","10.8","15","3","8","6","1","12","15","3","16","11","5","9","52","1"
"Kevin De Bruyne","BEL","MF,FW","Manchester City","18.9","17","9","7","5","5","5","23","18","8","0","8","7","10","1"
"Bobby De Cordova-Reid","JAM","FW","Leicester City","8.3","9","4","3","6","0","4","14","10","6","1","5","0","10","0"
"Liam Delap","ENG","FW","Ipswich Town","28.8","11","8","3","3","5","2","15","13","8","0","8","2","28","0"
"Sepp van den Berg","NED","DF","Brentford","28.7","39","24","25","10","4","19","29","10","52","38","14","21","134","3"
"Justin Devenny","NIR","MF","Crystal Palace","5.6","17","12","7","9","1","8","19","11","6","1","5","0","11","0"
"Kiernan Dewsbury-Hall","ENG","MF,FW","Chelsea","2.9","8","5","1","1","6","4","6","2","2","0","2","2","9","1"
"Amad Diallo","CIV","MF,FW","Manchester Utd","21.1","38","31","9","20","9","19","32","13","15","2","13","11","19","1"
"Rúben Dias","POR","DF","Manchester City","25.2","17","11","7","9","1","7","13","6","23","20","3","20","71","4"
"Luis Díaz","COL","FW","Liverpool","26.7","39","26","13","20","6","15","39","24","19","0","19","7","7","1"
"Tyler Dibling","ENG","FW,MF","Southampton","20.8","34","20","13","18","3","16","26","10","19","5","14","8","16","1"
"Lucas Digne","FRA","DF","Aston Villa","26.1","65","38","40","16","9","44","66","22","23","4","19","25","89","1"
"Issa Diop","FRA","DF","Fulham","14.9","26","12","18","8","0","13","18","5","10","7","3","9","72","2"
"Axel Disasi","FRA","DF","Aston Villa","5.4","8","5","7","1","0","3","7","4","4","1","3","5","18","0"
"Axel Disasi","FRA","DF","Chelsea","4.0","7","4","5","1","1","6","11","5","4","1","3","2","11","1"
"Roman Dixon","ENG","DF","Everton","1.0","5","5","3","2","0","4","4","0","1","0","1","1","3","0"
"Nasser Djiga","BFA","DF","Wolves","0.7","0","0","0","0","0","0","1","1","0","0","0","2","4","1"
"Matt Doherty","IRL","DF","Wolves","23.4","38","21","25","13","0","17","25","8","28","15","13","22","102","3"
"Jeremy Doku","BEL","FW,MF","Manchester City","16.8","31","22","9","12","10","8","15","7","11","1","10","4","2","0"
"Nicolás Domínguez","ARG","MF,FW","Nott'ham Forest","21.8","86","45","40","35","11","36","76","40","38","12","26","29","54","1"
"Patrick Dorgu","DEN","DF","Manchester Utd","9.4","31","24","15","14","2","16","23","7","11","0","11","4","23","2"
"Alfie Dorrington","ENG","DF","Tottenham","0.2","0","0","0","0","0","0","0","0","0","0","0","0","0","0"
"Abdoulaye Doucouré","MLI","MF","Everton","28.5","48","28","21","20","7","14","43","29","31","6","25","10","20","1"
"Cheick Doucouré","MLI","MF","Crystal Palace","5.0","16","8","6","8","2","5","11","6","4","0","4","11","10","1"
"Flynn Downes","ENG","MF","Southampton","23.9","49","25","23","21","5","15","36","21","28","9","19","32","51","4"
"Tommy Doyle","ENG","MF","Wolves","5.4","11","6","6","3","2","6","15","9","11","5","6","5","11","1"
"Radu Drăgușin","ROU","DF","Tottenham","13.9","10","6","8","2","0","6","12","6","22","16","6","15","49","4"
"Martin Dúbravka","SVK","GK","Newcastle Utd","10.0","0","0","0","0","0","0","0","0","0","0","0","0","3","0"
"Lewis Dunk","ENG","DF","Brighton","23.1","17","10","8","7","2","11","19","8","28","18","10","13","79","2"
"Jáder Durán","COL","FW","Aston Villa","7.1","8","7","1","2","5","1","4","3","5","0","5","0","13","0"
"Claudio Echeverri","ARG","FW","Manchester City","0.1","1","0","0","1","0","1","1","0","0","0","0","0","0","0"
"Ederson","BRA","GK","Manchester City","25.8","0","0","0","0","0","0","2","2","0","0","0","1","11","4"
"George Edmundson","ENG","DF","Ipswich Town","0.0","0","0","0","0","0","0","0","0","0","0","0","0","0","0"
"Odsonne Édouard","FRA","MF,FW","Crystal Palace","1.3","1","0","0","1","0","0","2","2","1","0","1","0","1","0"
"Odsonne Édouard","FRA","FW","Leicester City","0.3","1","1","1","0","0","0","0","0","0","0","0","0","1","0"
"Samuel Edozie","ENG","DF,FW","Southampton","0.7","3","1","0","1","2","2","2","0","0","0","0","0","0","0"
"Ronnie Edwards","ENG","DF","Southampton","0.1","0","0","0","0","0","0","0","0","1","1","0","0","0","0"
"Anthony Elanga","SWE","FW,MF","Nott'ham Forest","27.8","19","14","8","8","3","5","17","12","11","1","10","6","25","0"
"Harvey Elliott","ENG","MF","Liverpool","4.1","5","3","3","1","1","2","8","6","7","2","5","1","3","1"
"Yunus Emre Konak","TUR","FW,MF","Brentford","0.5","4","4","0","4","0","1","2","1","2","0","2","0","0","0"
"Julio Enciso","PAR","MF,FW","Ipswich Town","9.7","12","9","3","6","3","4","11","7","8","1","7","1","6","0"
"Julio Enciso","PAR","MF,FW","Brighton","3.3","0","0","0","0","0","0","2","2","2","0","2","0","1","0"
"Wataru Endo","JPN","MF,DF","Liverpool","3.0","12","8","7","5","0","6","10","4","8","1","7","6","9","0"
"Christian Eriksen","DEN","MF","Manchester Utd","11.8","19","9","4","12","3","11","27","16","15","5","10","7","8","0"
"Romain Esse","ENG","MF","Crystal Palace","1.5","9","6","4","3","2","5","5","0","2","0","2","1","2","0"
"Pervis Estupiñán","ECU","DF","Brighton","26.7","65","43","33","25","7","34","51","17","20","5","15","37","65","2"
"Evanilson","BRA","FW","Bournemouth","25.8","16","10","6","5","5","8","12","4","11","2","9","1","21","0"
"Jake Evans",NA,"FW","Leicester City","0.3","1","1","0","0","1","0","1","1","0","0","0","0","1","0"
"Jonny Evans","NIR","DF","Manchester Utd","3.5","8","6","4","4","0","3","6","3","3","2","1","5","15","0"
"Eberechi Eze","ENG","MF,FW","Crystal Palace","28.8","39","22","14","16","9","17","36","19","27","0","27","11","10","3"
"Łukasz Fabiański","POL","GK","West Ham","12.9","0","0","0","0","0","0","1","1","0","0","0","0","5","1"
"Wout Faes","BEL","DF","Leicester City","31.3","42","26","26","14","2","25","48","23","48","35","13","26","185","4"
"Abdul Fatawu Issahaku","GHA","FW","Leicester City","6.4","21","15","13","2","6","11","19","8","7","0","7","4","12","0"
"João Félix","POR","FW,MF","Chelsea","4.1","8","3","2","5","1","5","9","4","2","0","2","3","2","0"
"Evan Ferguson","IRL","FW","West Ham","1.7","3","1","0","1","2","0","0","0","2","1","1","1","1","0"
"Evan Ferguson","IRL","FW","Brighton","2.7","4","3","0","3","1","2","5","3","3","1","2","0","4","0"
"Bruno Fernandes","POR","MF","Manchester Utd","33.5","84","50","27","38","19","34","85","51","35","6","29","26","35","3"
"Mateus Fernandes","POR","MF","Southampton","32.3","89","48","45","28","16","33","72","39","43","8","35","28","35","7"
"Enzo Fernández","ARG","MF","Chelsea","32.7","65","33","17","30","18","31","84","53","43","7","36","13","23","4"
"Mark Flekken","NED","GK","Brentford","36.4","4","4","4","0","0","3","9","6","2","0","2","0","26","4"
"Phil Foden","ENG","MF,FW","Manchester City","19.7","13","5","5","4","4","7","18","11","13","1","12","9","7","1"
"Wesley Fofana","FRA","DF","Chelsea","13.0","13","12","6","7","0","6","14","8","14","9","5","14","55","2"
"Carlos Forbs","POR","MF,FW","Wolves","2.7","8","5","5","2","1","4","6","2","3","0","3","1","2","1"
"Fraser Forster","ENG","GK","Tottenham","7.0","0","0","0","0","0","0","1","1","0","0","0","0","7","3"
"Matheus França","BRA","MF,FW","Crystal Palace","0.6","2","0","0","2","0","0","0","0","1","1","0","1","1","0"
"Ryan Fraser","SCO","FW,DF","Southampton","3.4","6","2","2","4","0","4","6","2","1","1","0","1","9","0"
"Tyler Fredricson","ENG","DF","Manchester Utd","1.8","5","3","3","2","0","1","2","1","2","0","2","1","11","0"
"Niclas Füllkrug","GER","FW","West Ham","8.8","4","3","0","1","3","3","4","1","1","0","1","1","16","0"
"Cody Gakpo","NED","FW","Liverpool","21.5","28","16","6","13","9","13","25","12","23","3","20","12","19","1"
"Idrissa Gana Gueye","SEN","MF","Everton","34.0","133","80","61","55","17","58","99","41","48","9","39","48","36","1"
"Andrés García","ESP","DF,MF","Aston Villa","3.5","9","5","5","3","1","4","8","4","2","0","2","2","10","2"
"Alejandro Garnacho","ARG","MF,FW","Manchester Utd","24.4","30","18","11","6","13","12","37","25","19","0","19","13","11","2"
"James Garner","ENG","MF,DF","Everton","17.7","47","31","25","20","2","24","41","17","20","4","16","23","37","0"
"Tyrique George","ENG","FW","Chelsea","2.0","2","0","2","0","0","2","3","1","1","0","1","2","1","0"
"Morgan Gibbs-White","ENG","MF","Nott'ham Forest","31.1","43","22","14","23","6","17","33","16","18","5","13","23","29","1"
"Billy Gilmour","SCO","MF","Brighton","1.1","3","3","2","1","0","3","4","1","1","0","1","0","1","0"
"Ben Godfrey","ENG","DF","Ipswich Town","1.8","1","0","1","0","0","1","1","0","1","1","0","2","3","0"
"Martial Godo","ENG","FW,DF","Fulham","0.3","0","0","0","0","0","0","0","0","1","0","1","1","0","0"
"Michael Golding","ENG","MF","Leicester City","0.0","0","0","0","0","0","0","0","0","0","0","0","0","0","0"
"João Gomes","BRA","MF","Wolves","33.0","116","71","55","53","8","48","110","62","42","4","38","25","33","0"
"Rodrigo Gomes","POR","DF,FW","Wolves","9.0","23","15","14","9","0","12","21","9","8","1","7","7","20","1"
"Toti Gomes","POR","DF","Wolves","29.0","61","43","42","15","4","37","46","9","29","17","12","25","152","5"
"Diego Gómez","PAR","MF","Brighton","5.7","21","13","11","8","2","12","22","10","13","0","13","8","10","1"
"Joe Gomez","ENG","DF","Liverpool","5.8","13","10","5","7","1","11","16","5","9","6","3","7","20","2"
"Nicolás González","ESP","MF","Manchester City","8.4","16","6","5","7","4","6","11","5","9","0","9","8","21","0"
"Anthony Gordon","ENG","FW,MF","Newcastle Utd","27.0","32","18","9","18","5","12","37","25","25","2","23","7","9","3"
"Ryan Gravenberch","NED","MF","Liverpool","35.1","69","35","27","29","13","32","56","24","35","10","25","60","59","2"
"Archie Gray","ENG","DF,MF","Tottenham","19.5","16","8","4","8","4","7","17","10","22","11","11","19","50","2"
"Jack Grealish","ENG","FW,MF","Manchester City","8.0","9","5","4","2","3","2","5","3","12","2","10","2","6","1"
"Jacob Greaves","ENG","DF","Ipswich Town","24.5","40","21","20","17","3","22","35","13","41","26","15","21","148","3"
"Brajan Gruda","GER","MF,FW","Brighton","7.6","16","8","6","6","4","7","14","7","8","0","8","2","5","1"
"Albert Grønbaek","DEN","FW,MF","Southampton","1.6","4","1","1","1","2","3","10","7","1","1","0","0","1","0"
"Gonçalo Guedes","POR","MF,FW","Wolves","11.1","16","5","2","6","8","4","16","12","11","0","11","5","4","0"
"Marc Guéhi","ENG","DF","Crystal Palace","34.0","61","34","36","23","2","31","47","16","55","23","32","28","163","2"
"Luis Guilherme","BRA","MF,FW","West Ham","1.7","1","0","1","0","0","0","3","3","7","0","7","3","2","0"
"Bruno Guimarães","BRA","MF","Newcastle Utd","36.3","83","47","41","30","12","33","69","36","36","10","26","29","44","5"
"Marc Guiu","ESP","FW","Chelsea","0.8","1","1","0","1","0","1","1","0","0","0","0","0","0","0"
"İlkay Gündoğan","GER","MF","Manchester City","24.7","25","13","5","15","5","10","24","14","15","0","15","13","23","0"
"Malo Gusto","FRA","DF","Chelsea","20.7","45","29","27","15","3","25","48","23","29","8","21","24","49","5"
"Joško Gvardiol","CRO","DF","Manchester City","36.4","58","39","25","21","12","21","40","19","42","20","22","44","122","8"
"Erling Haaland","NOR","FW","Manchester City","30.4","11","6","3","3","5","3","8","5","12","1","11","5","23","0"
"Lewis Hall","ENG","DF","Newcastle Utd","24.3","58","41","28","22","8","40","74","34","33","18","15","18","75","3"
"Ali Al Hamadi","IRQ","FW","Ipswich Town","1.5","1","0","0","0","1","0","2","2","0","0","0","0","2","0"
"Marcus Harness","ENG","MF","Ipswich Town","0.5","1","0","0","0","1","0","3","3","2","1","1","0","1","0"
"Jack Harrison","ENG","FW","Everton","23.1","32","22","12","12","8","15","46","31","18","2","16","10","35","2"
"Taylor Harwood-Bellis","ENG","DF","Southampton","31.4","28","20","13","12","3","19","35","16","65","43","22","30","141","6"
"Kai Havertz","GER","FW,MF","Arsenal","20.8","16","9","3","6","7","4","15","11","23","4","19","6","33","1"
"Ayden Heaven","ENG","DF","Manchester Utd","1.9","4","3","1","3","0","2","2","0","2","2","0","4","9","0"
"Jan Paul van Hecke","NED","DF","Brighton","32.9","45","29","24","19","2","23","41","18","37","22","15","24","142","2"
"Hwang Hee-chan","KOR","MF,FW","Wolves","7.3","6","4","2","1","3","2","6","4","9","0","9","2","11","0"
"Dean Henderson","ENG","GK","Crystal Palace","38.0","2","1","2","0","0","2","6","4","0","0","0","0","22","0"
"Rico Henry","ENG","DF","Brentford","1.1","2","2","1","0","1","0","4","4","4","1","3","1","2","0"
"Mads Hermansen","DEN","GK","Leicester City","26.5","1","1","1","0","0","1","1","0","1","0","1","0","13","4"
"Son Heung-min","KOR","FW","Tottenham","23.4","17","9","3","8","6","5","27","22","11","0","11","5","17","1"
"James Hill","ENG","DF","Bournemouth","5.0","15","8","6","6","3","3","11","8","5","0","5","9","31","0"
"Jack Hinshelwood","ENG","MF,DF","Brighton","20.5","27","19","8","10","9","11","27","16","10","3","7","16","37","1"
"George Hirst","SCO","FW","Ipswich Town","7.3","3","3","1","0","2","1","4","3","1","1","0","2","10","0"
"Mason Holgate","JAM","FW,DF","Everton","0.1","0","0","0","0","0","0","0","0","0","0","0","0","0","0"
"Harry Howell","ENG","FW","Brighton","0.1","1","1","1","0","0","1","2","1","1","0","1","0","0","0"
"Callum Hudson-Odoi","ENG","FW,MF","Nott'ham Forest","24.4","22","14","8","8","6","12","18","6","11","0","11","13","12","1"
"Will Hughes","ENG","MF","Crystal Palace","23.4","66","36","20","33","13","28","62","34","31","14","17","22","28","3"
"Dean Huijsen","ESP","DF","Bournemouth","27.0","36","26","19","16","1","18","29","11","40","29","11","51","198","4"
"Omari Hutchinson","ENG","MF,FW","Ipswich Town","28.7","32","13","14","10","8","13","48","35","27","2","25","11","15","1"
"Rasmus Højlund","DEN","FW","Manchester Utd","22.3","3","1","0","2","1","0","5","5","6","0","6","2","6","0"
"Igor","BRA","DF","Brighton","10.7","5","5","2","2","1","4","10","6","24","14","10","4","39","1"
"Danny Ings","ENG","FW,MF","West Ham","3.2","4","2","2","2","0","1","3","2","5","0","5","1","4","0"
"Tim Iroegbunam","ENG","MF","Everton","6.4","29","14","14","10","5","14","23","9","18","4","14","16","12","1"
"Andy Irving","SCO","MF","West Ham","1.8","7","4","3","3","1","1","5","4","5","1","4","1","5","0"
"Alexander Isak","SWE","FW","Newcastle Utd","30.6","12","5","2","3","7","5","15","10","18","2","16","3","17","1"
"Alex Iwobi","NGA","FW,MF","Fulham","33.1","44","25","14","21","9","22","34","12","26","1","25","14","29","1"
"Nicolas Jackson","SEN","FW","Chelsea","24.7","22","13","6","7","9","5","10","5","15","2","13","3","15","0"
"Reece James","ENG","DF,MF","Chelsea","11.8","10","9","6","3","1","3","9","6","14","6","8","13","23","4"
"Vitaly Janelt","GER","MF","Brentford","25.0","38","22","14","13","11","21","36","15","33","9","24","27","53","1"
"Vitezslav Jaros","CZE","GK","Liverpool","0.1","0","0","0","0","0","0","0","0","0","0","0","0","0","0"
"Daniel Jebbison","CAN","FW","Bournemouth","1.3","5","3","3","2","0","4","6","2","2","1","1","1","1","0"
"Mathias Jensen","DEN","MF","Brentford","9.6","14","10","6","6","2","8","16","8","15","4","11","8","13","2"
"Gabriel Jesus","BRA","FW","Arsenal","6.8","10","6","4","3","3","4","9","5","10","1","9","4","8","0"
"Raúl Jiménez","MEX","FW","Fulham","27.7","35","24","9","17","9","8","22","14","21","5","16","10","23","3"
"Kim Jisoo","KOR","DF","Brentford","0.3","0","0","0","0","0","0","0","0","0","0","0","0","2","0"
"João Pedro","BRA","FW,MF","Brighton","21.6","16","12","6","6","4","4","11","7","12","0","12","9","12","0"
"Joelinton","BRA","MF,FW","Newcastle Utd","26.6","57","35","23","23","11","25","44","19","37","7","30","23","47","2"
"Ben Johnson","ENG","DF,FW","Ipswich Town","15.0","38","22","23","12","3","20","41","21","22","5","17","13","54","1"
"Brennan Johnson","WAL","FW","Tottenham","24.2","39","26","9","20","10","16","34","18","25","3","22","4","14","0"
"Sam Johnstone","ENG","GK","Wolves","7.0","0","0","0","0","0","0","1","1","0","0","0","0","7","0"
"Curtis Jones","ENG","MF,DF","Liverpool","19.0","39","22","6","23","10","17","27","10","22","9","13","7","10","3"
"Jorginho","ITA","MF","Arsenal","7.8","12","4","1","7","4","8","20","12","3","0","3","7","2","2"
"Diogo Jota","POR","FW","Liverpool","13.3","14","8","2","8","4","7","19","12","9","0","9","8","6","0"
"James Justin","ENG","DF","Leicester City","32.4","58","37","29","23","6","32","55","23","48","17","31","46","141","3"
"Filip Jørgensen","DEN","GK","Chelsea","6.0","0","0","0","0","0","0","0","0","0","0","0","0","0","3"
"Ferdi Kadioglu","TUR","DF,MF","Brighton","4.3","10","6","4","5","1","6","15","9","2","2","0","8","17","0"
"Daichi Kamada","JPN","MF","Crystal Palace","17.4","47","29","19","24","4","14","41","27","22","5","17","18","14","0"
"Boubacar Kamara","FRA","MF","Aston Villa","19.2","50","21","28","18","4","29","56","27","19","7","12","19","51","3"
"Joachim Kayi Sanda","FRA","DF","Southampton","0.2","0","0","0","0","0","0","0","0","0","0","0","2","0","0"
"Michael Kayode","ITA","DF","Brentford","5.9","17","11","12","5","0","9","13","4","3","0","3","7","19","0"
"Michael Keane","ENG","DF","Everton","11.7","12","9","8","2","2","8","15","7","14","10","4","16","65","2"
"Caoimhín Kelleher","IRL","GK","Liverpool","10.0","0","0","0","0","0","0","0","0","0","0","0","0","1","2"
"Lloyd Kelly","ENG","DF","Newcastle Utd","3.4","5","4","4","1","0","1","1","0","6","4","2","1","17","0"
"Milos Kerkez","HUN","DF","Bournemouth","37.1","52","26","25","20","7","24","38","14","38","11","27","45","106","4"
"Bilal El Khannouss","MAR","MF,FW","Leicester City","24.2","50","30","16","29","5","17","32","15","22","4","18","6","10","3"
"Abdukodir Khusanov","UZB","DF","Manchester City","5.6","5","4","4","1","0","2","3","1","5","4","1","3","29","1"
"Max Kilman","ENG","DF","West Ham","37.2","39","24","16","20","3","23","27","4","58","40","18","38","212","6"
"Joshua King","ENG","MF","Fulham","1.4","7","5","3","4","0","0","3","3","3","0","3","1","1","0"
"Tom King","WAL","GK","Wolves","0.0","0","0","0","0","0","0","0","0","0","0","0","0","0","0"
"Antonín Kinský","CZE","GK","Tottenham","6.0","3","1","3","0","0","1","1","0","0","0","0","0","9","1"
"Jakub Kiwior","POL","DF","Arsenal","12.5","22","8","13","7","2","11","15","4","13","8","5","6","58","3"
"Justin Kluivert","NED","MF","Bournemouth","26.0","23","11","4","11","8","4","22","18","24","0","24","14","24","1"
"Ibrahima Konaté","FRA","DF","Liverpool","28.4","40","26","25","13","2","25","35","10","29","15","14","17","133","3"
"Ezri Konsa","ENG","DF","Aston Villa","32.6","34","18","20","10","4","20","25","5","20","11","9","24","114","4"
"Mateo Kovačić","CRO","MF","Manchester City","24.4","69","38","23","38","8","31","65","34","20","0","20","24","21","1"
"Caleb Kporha","ENG","DF","Crystal Palace","0.1","2","1","2","0","0","2","2","0","0","0","0","0","1","0"
"Emil Krafth","SWE","DF","Newcastle Utd","3.8","4","2","2","1","1","2","3","1","5","4","1","2","16","0"
"Mohammed Kudus","GHA","FW,MF","West Ham","28.8","38","23","9","18","11","10","27","17","24","1","23","4","8","2"
"Dejan Kulusevski","SWE","MF,FW","Tottenham","26.5","45","23","17","13","15","19","51","32","34","5","29","13","10","1"
"Maxence Lacroix","FRA","DF","Crystal Palace","34.6","68","41","52","15","1","32","47","15","48","22","26","54","207","2"
"Adam Lallana","ENG","MF","Southampton","4.0","8","5","4","4","0","2","12","10","4","1","3","5","5","0"
"Tariq Lamptey","GHA","DF","Brighton","9.6","17","11","8","9","0","9","25","16","15","7","8","7","23","1"
"Will Lankshear","ENG","FW,MF","Tottenham","0.1","0","0","0","0","0","0","0","0","0","0","0","0","0","0"
"Roméo Lavia","BEL","MF","Chelsea","8.9","22","13","5","13","4","10","21","11","6","0","6","16","10","1"
"Mario Lemina","GAB","MF,DF","Wolves","15.2","51","31","27","19","5","20","29","9","12","7","5","27","50","3"
"Bernd Leno","GER","GK","Fulham","38.0","2","2","2","0","0","2","2","0","1","0","1","0","11","5"
"Jefferson Lerma","COL","MF,DF","Crystal Palace","25.3","35","17","15","16","4","19","36","17","38","18","20","42","80","1"
"Rico Lewis","ENG","DF,MF","Manchester City","21.0","30","19","13","12","5","13","21","8","28","7","21","13","45","1"
"Keane Lewis-Potter","ENG","DF,FW","Brentford","34.4","49","27","26","16","7","31","50","19","28","10","18","21","76","3"
"Myles Lewis-Skelly","ENG","DF","Arsenal","15.2","22","14","10","9","3","10","11","1","4","1","3","7","27","0"
"Matthijs de Ligt","NED","DF","Manchester Utd","23.6","30","22","17","12","1","23","32","9","29","21","8","33","96","0"
"Pedro Lima","BRA","DF","Wolves","0.8","1","0","0","0","1","1","3","2","0","0","0","2","5","0"
"Victor Lindelöf","SWE","DF","Manchester Utd","7.8","7","2","5","1","1","3","4","1","6","4","2","8","36","2"
"Jesper Lindstrøm","DEN","FW","Everton","13.8","45","25","24","19","2","19","55","36","15","3","12","12","17","0"
"Valentino Livramento","ENG","DF","Newcastle Utd","31.6","54","36","35","15","4","32","59","27","37","11","26","23","108","1"
"Sean Longstaff","ENG","MF","Newcastle Utd","8.9","27","16","10","9","8","18","27","9","17","5","12","7","8","0"
"Saša Lukić","SRB","MF","Fulham","26.0","68","39","22","40","6","23","55","32","20","7","13","28","35","1"
"Joe Lumley","ENG","GK","Southampton","3.0","0","0","0","0","0","0","0","0","0","0","0","0","3","3"
"Massimo Luongo","AUS","MF","Ipswich Town","2.2","9","6","6","2","1","5","8","3","4","2","2","2","2","0"
"Ian Maatsen","NED","DF","Aston Villa","12.7","29","17","17","9","3","17","24","7","13","0","13","15","39","3"
"Alexis Mac Allister","ARG","MF","Liverpool","28.9","95","58","28","51","16","55","104","49","61","6","55","22","29","1"
"James Maddison","ENG","MF","Tottenham","20.1","31","19","8","16","7","9","29","20","15","4","11","12","19","1"
"Noni Madueke","ENG","FW","Chelsea","22.6","25","18","8","12","5","14","38","24","17","0","17","10","11","0"
"Gabriel Magalhães","BRA","DF","Arsenal","26.3","25","15","12","8","5","12","16","4","42","29","13","16","93","2"
"Edmond-Paris Maghoma","ENG","MF,FW","Brentford","1.3","2","1","0","2","0","1","3","2","2","2","0","1","2","0"
"Harry Maguire","ENG","DF","Manchester Utd","19.5","30","15","23","6","1","17","23","6","15","12","3","40","78","1"
"Kobbie Mainoo","ENG","MF","Manchester Utd","18.3","46","29","18","14","14","24","40","16","16","2","14","19","14","1"
"Tyrell Malacia","NED","DF","Manchester Utd","1.1","2","1","2","0","0","1","2","1","0","0","0","1","1","1"
"Donyell Malen","NED","FW","Aston Villa","3.4","7","4","3","3","1","1","4","3","2","0","2","0","1","0"
"Mateus Mane",NA,"MF","Wolves","0.0","0","0","0","0","0","0","0","0","1","0","1","0","0","0"
"Orel Mangala","BEL","MF","Everton","14.0","16","8","3","11","2","5","8","3","8","3","5","21","24","1"
"Ryan Manning","IRL","DF,MF","Southampton","16.2","28","17","16","10","2","14","26","12","20","11","9","17","47","0"
"Solly March","ENG","FW,MF","Brighton","1.9","6","3","2","2","2","5","8","3","3","0","3","2","2","1"
"Omar Marmoush","EGY","FW,MF","Manchester City","13.1","13","8","2","9","2","8","16","8","15","1","14","6","3","0"
"Gabriel Martinelli","BRA","FW,MF","Arsenal","25.4","23","15","9","6","8","7","23","16","15","0","15","5","19","0"
"Emiliano Martínez","ARG","GK","Aston Villa","35.5","3","3","3","0","0","2","2","0","1","0","1","0","17","6"
"Lisandro Martínez","ARG","DF","Manchester Utd","19.5","40","24","25","12","3","21","36","15","22","8","14","32","57","1"
"Pape Matar Sarr","SEN","MF","Tottenham","21.3","49","36","19","23","7","12","25","13","26","10","16","30","25","1"
"Jean-Philippe Mateta","FRA","FW","Crystal Palace","29.4","18","12","5","11","2","3","16","13","19","4","15","2","23","0"
"Stephy Mavididi","ENG","FW","Leicester City","17.9","34","19","16","10","8","14","42","28","26","2","24","11","15","0"
"Konstantinos Mavropanos","GRE","DF","West Ham","22.7","35","24","24","10","1","16","27","11","25","18","7","40","126","1"
"Noussair Mazraoui","MAR","DF","Manchester Utd","31.5","115","68","58","42","15","59","94","35","36","9","27","34","95","1"
"Bryan Mbeumo","CMR","FW","Brentford","37.9","49","31","18","15","16","21","35","14","26","3","23","14","55","1"
"James Mcatee","ENG","MF,FW","Manchester City","3.9","5","2","0","4","1","1","7","6","8","0","8","2","1","0"
"Kasey McAteer","IRL","FW","Leicester City","9.5","23","16","11","9","3","14","29","15","18","2","16","5","15","0"
"Alex McCarthy","ENG","GK","Southampton","5.0","0","0","0","0","0","0","0","0","0","0","0","0","1","4"
"John McGinn","SCO","MF,FW","Aston Villa","24.7","33","24","10","14","9","13","31","18","22","2","20","14","18","3"
"Dwight McNeil","ENG","MF,FW","Everton","15.2","13","8","6","5","2","9","21","12","7","0","7","6","2","1"
"Scott McTominay","SCO","MF","Manchester Utd","0.2","0","0","0","0","0","0","1","1","0","0","0","0","1","0"
"Ben Mee","ENG","DF","Brentford","2.0","2","2","0","2","0","1","1","0","3","3","0","4","7","0"
"Jayden Meghoma","ENG","DF","Brentford","0.1","0","0","0","0","0","0","0","0","0","0","0","0","0","0"
"Mikel Merino","ESP","MF,FW","Arsenal","17.6","46","28","7","26","13","20","36","16","18","5","13","15","26","2"
"Shumaira Mheuka","ENG","MF","Chelsea","0.0","0","0","0","0","0","0","0","0","0","0","0","0","0","0"
"Nikola Milenković","SRB","DF","Nott'ham Forest","37.0","51","29","36","13","2","27","34","7","41","24","17","27","209","1"
"Lewis Miley","ENG","MF","Newcastle Utd","3.5","14","11","5","7","2","7","14","7","5","1","4","2","5","2"
"James Milner","ENG","MF","Brighton","1.9","5","2","1","3","1","3","3","0","4","2","2","2","2","1"
"Tyrone Mings","ENG","DF","Aston Villa","12.4","7","6","6","1","0","2","2","0","13","11","2","7","61","1"
"Yankuba Minteh","GAM","FW,MF","Brighton","20.4","48","35","25","13","10","17","45","28","22","0","22","11","31","0"
"Tyrick Mitchell","ENG","DF","Crystal Palace","34.4","91","55","57","27","7","25","46","21","68","12","56","19","108","2"
"Kaoru Mitoma","JPN","FW,MF","Brighton","28.9","45","27","15","14","16","19","49","30","48","3","45","14","10","0"
"Jakub Moder","POL","MF","Brighton","0.1","1","0","1","0","0","0","2","2","0","0","0","0","3","0"
"Jeremy Monga",NA,"FW,MF","Leicester City","1.2","2","1","0","1","1","1","1","0","3","2","1","0","1","0"
"Mikey Moore","ENG","FW","Tottenham","4.1","2","1","2","0","0","0","4","4","2","0","2","1","4","0"
"Morato","BRA","DF","Nott'ham Forest","10.1","22","14","18","3","1","13","21","8","14","5","9","10","78","2"
"Álex Moreno","ESP","DF,MF","Nott'ham Forest","10.6","25","18","20","5","0","15","39","24","11","5","6","15","43","0"
"Sam Morsy","EGY","MF","Ipswich Town","30.6","68","41","40","24","4","27","62","35","34","13","21","29","47","5"
"Yerson Mosquera","COL","DF","Wolves","4.9","11","7","9","2","0","9","14","5","13","10","3","10","14","0"
"Mason Mount","ENG","MF","Manchester Utd","6.9","15","5","5","8","2","9","12","3","11","1","10","4","4","0"
"Divin Mubama","ENG","FW","Manchester City","0.3","0","0","0","0","0","0","0","0","0","0","0","0","0","0"
"Mykhailo Mudryk","UKR","FW","Chelsea","1.7","2","2","2","0","0","0","0","0","3","1","2","0","1","0"
"Marshall Munetsi","ZIM","MF,FW","Wolves","12.0","24","10","7","11","6","13","23","10","14","1","13","6","18","0"
"Rodrigo Muniz","BRA","FW","Fulham","10.7","10","5","3","5","2","4","4","0","9","2","7","5","14","0"
"Daniel Muñoz","COL","DF","Crystal Palace","35.9","123","80","57","41","25","55","97","42","40","6","34","44","108","1"
"Arijanet Muric","KVX","GK","Ipswich Town","18.0","0","0","0","0","0","0","2","2","0","0","0","0","10","5"
"Murillo","BRA","DF","Nott'ham Forest","35.4","53","36","38","12","3","27","46","19","69","45","24","36","249","3"
"Jacob Murphy","ENG","FW","Newcastle Utd","26.2","28","19","10","12","6","20","44","24","31","0","31","13","35","1"
"Vitaliy Mykolenko","UKR","DF","Everton","34.2","63","38","39","14","10","29","56","27","25","10","15","44","145","2"
"Iliman Ndiaye","SEN","FW","Everton","27.0","53","28","20","16","17","22","49","27","30","5","25","20","24","1"
"Wilfred Ndidi","NGA","MF","Leicester City","25.8","85","51","45","32","8","30","61","31","47","19","28","31","80","0"
"Kosta Nedeljković","SRB","DF","Aston Villa","1.4","7","5","1","3","3","2","3","1","1","0","1","0","3","0"
"Reiss Nelson","ENG","FW","Arsenal","0.0","1","0","0","1","0","0","1","1","0","0","0","0","1","0"
"Reiss Nelson","ENG","FW","Fulham","5.4","8","6","3","3","2","5","13","8","11","0","11","5","2","0"
"Neto","BRA","GK","Bournemouth","2.0","0","0","0","0","0","0","0","0","0","0","0","0","1","1"
"Pedro Neto","POR","FW","Chelsea","25.2","23","9","9","9","5","9","21","12","14","2","12","9","6","0"
"Eddie Nketiah","ENG","FW,MF","Crystal Palace","11.5","15","8","7","4","4","7","13","6","10","1","9","3","12","0"
"Christopher Nkunku","FRA","FW","Chelsea","10.2","12","8","3","4","5","6","8","2","9","2","7","7","10","0"
"Gustavo Nunes","BRA","FW,MF","Brentford","0.1","3","2","2","0","1","2","2","0","0","0","0","0","2","0"
"Matheus Nunes","POR","DF,MF","Manchester City","18.6","35","22","15","14","6","16","38","22","17","4","13","15","38","2"
"Darwin Núñez","URU","FW","Liverpool","12.6","21","18","11","4","6","7","18","11","6","0","6","4","12","0"
"Ethan Nwaneri","ENG","FW,MF","Arsenal","9.9","11","7","4","4","3","7","21","14","8","2","6","2","4","1"
"Christian Nørgaard","DEN","MF","Brentford","31.3","79","49","37","35","7","48","81","33","52","20","32","49","70","1"
"Jake O'Brien","IRL","DF","Everton","17.5","26","17","21","5","0","17","25","8","17","4","13","4","93","0"
"Matt O'Riley","DEN","MF","Brighton","10.4","16","9","4","8","4","4","13","9","7","3","4","13","9","1"
"Dara O'Shea","IRL","DF","Ipswich Town","34.7","49","31","33","13","3","22","34","12","62","50","12","33","225","4"
"Chidozie Obi-Martin","DEN","FW","Manchester Utd","1.8","2","1","0","0","2","2","2","0","0","0","0","0","1","0"
"Wilson Odobert","FRA","FW,MF","Tottenham","9.4","14","5","5","4","5","8","14","6","6","0","6","4","5","1"
"Chiedozie Ogbene","IRL","FW","Ipswich Town","2.6","7","3","1","2","4","2","4","2","1","0","1","1","3","0"
"Caleb Okoli","ITA","DF","Leicester City","12.5","25","14","8","15","2","11","18","7","24","14","10","15","79","3"
"Robin Olsen","SWE","GK","Aston Villa","2.5","1","0","1","0","0","1","1","0","0","0","0","0","2","1"
"Amadou Onana","BEL","MF","Aston Villa","18.0","55","30","23","26","6","16","29","13","16","7","9","26","41","3"
"André Onana","CMR","GK","Manchester Utd","34.0","2","2","2","0","0","2","4","2","0","0","0","0","11","4"
"Paul Onuachu","NGA","FW","Southampton","11.7","7","2","1","5","1","3","7","4","7","2","5","1","16","1"
"Frank Onyeka","NGA","MF","Brentford","0.3","0","0","0","0","0","0","0","0","0","0","0","0","0","0"
"Lewis Orford","ENG","MF","West Ham","0.5","0","0","0","0","0","0","0","0","1","0","1","1","0","0"
"Stefan Ortega","GER","GK","Manchester City","12.2","0","0","0","0","0","0","1","1","0","0","0","0","11","1"
"William Osula","DEN","FW","Newcastle Utd","1.5","2","0","1","0","1","0","2","2","0","0","0","4","2","0"
"Dango Ouattara","BFA","FW","Bournemouth","22.3","35","26","14","11","10","17","41","24","36","10","26","11","51","0"
"Nico O’Reilly","ENG","DF","Manchester City","5.9","9","4","3","3","3","4","8","4","5","1","4","4","12","0"
"Alex Palmer","ENG","GK","Ipswich Town","13.0","0","0","0","0","0","0","0","0","0","0","0","0","12","0"
"Cole Palmer","ENG","MF,FW","Chelsea","35.5","34","20","12","10","12","12","27","15","16","1","15","11","20","1"
"Emerson Palmieri","ITA","DF","West Ham","23.5","60","31","37","18","5","27","48","21","32","8","24","21","59","0"
"Lucas Paquetá","BRA","MF,FW","West Ham","26.4","66","37","25","30","11","27","55","28","29","4","25","18","37","6"
"Thomas Partey","GHA","MF,DF","Arsenal","31.1","89","53","26","39","24","46","76","30","29","9","20","35","49","4"
"Nathan Patterson","SCO","DF","Everton","3.9","11","6","7","4","0","7","14","7","2","0","2","2","7","0"
"Andreas Pereira","BRA","MF","Fulham","22.4","24","13","8","11","5","10","42","32","17","2","15","8","17","3"
"Ricardo Pereira","POR","DF","Leicester City","4.3","13","8","4","6","3","7","14","7","8","3","5","4","11","0"
"Kalvin Phillips","ENG","MF","Ipswich Town","13.7","35","19","8","20","7","15","39","24","35","6","29","19","37","2"
"Jaden Philogene Bidace","ENG","FW,MF","Aston Villa","3.7","11","5","4","7","0","4","6","2","5","0","5","3","2","1"
"Jaden Philogene Bidace","ENG","FW,DF","Ipswich Town","5.3","14","7","6","6","2","8","15","7","11","1","10","10","9","1"
"Jordan Pickford","ENG","GK","Everton","38.0","1","0","1","0","0","1","2","1","0","0","0","1","30","2"
"Ethan Pinnock","JAM","DF","Brentford","21.3","35","19","15","16","4","13","24","11","29","18","11","24","142","4"
"Daniel Podence","POR","MF,FW","Wolves","0.5","0","0","0","0","0","0","1","1","0","0","0","0","0","0"
"Alfie Pond","ENG","DF","Wolves","0.0","0","0","0","0","0","0","0","0","0","0","0","0","0","0"
"Nick Pope","ENG","GK","Newcastle Utd","28.0","0","0","0","0","0","0","0","0","1","0","1","1","32","5"
"Pedro Porro","ESP","DF","Tottenham","29.0","66","49","34","22","10","44","77","33","44","17","27","36","84","2"
"Jarell Quansah","ENG","DF","Liverpool","5.5","12","8","8","4","0","7","10","3","10","7","3","7","28","1"
"Hákon Rafn Valdimarsson","ISL","GK","Brentford","1.6","0","0","0","0","0","0","0","0","0","0","0","0","2","0"
"Aaron Ramsdale","ENG","GK","Southampton","30.0","0","0","0","0","0","0","3","3","0","0","0","2","10","3"
"Jacob Ramsey","ENG","FW,MF","Aston Villa","18.0","30","15","14","10","6","10","20","10","23","4","19","8","8","1"
"Marcus Rashford","ENG","FW,MF","Manchester Utd","10.9","7","4","2","2","3","3","9","6","8","0","8","4","7","0"
"Marcus Rashford","ENG","FW","Aston Villa","4.9","10","7","2","3","5","4","6","2","2","0","2","1","3","0"
"David Raya","ESP","GK","Arsenal","38.0","0","0","0","0","0","0","2","2","0","0","0","2","21","9"
"Harrison Reed","ENG","MF","Fulham","1.2","6","3","3","2","1","1","3","2","1","0","1","1","3","0"
"Remy Rees-Dottin","ENG","FW","Bournemouth","0.0","0","0","0","0","0","0","0","0","0","0","0","0","0","0"
"Sergio Reguilón","ESP","DF","Tottenham","2.2","4","3","1","3","0","2","5","3","7","0","7","4","8","0"
"Vitor Reis","BRA","DF","Manchester City","0.0","0","0","0","0","0","0","0","0","0","0","0","0","1","0"
"Chadi Riad","MAR","DF","Crystal Palace","1.0","5","2","2","2","1","2","3","1","0","0","0","2","0","0"
"Declan Rice","ENG","MF","Arsenal","31.4","53","25","22","25","6","17","41","24","27","13","14","25","51","0"
"Chris Richards","USA","DF","Crystal Palace","21.4","47","30","24","17","6","24","41","17","40","14","26","19","121","0"
"Richarlison","BRA","FW","Tottenham","5.6","5","3","0","4","1","0","3","3","1","1","0","0","8","0"
"Andrew Robertson","SCO","DF","Liverpool","27.6","39","22","25","10","4","31","51","20","10","4","6","21","54","2"
"Antonee Robinson","USA","DF","Fulham","35.2","95","61","57","31","7","45","95","50","43","9","34","62","133","2"
"Jay Robinson","ENG","MF,FW","Southampton","1.5","4","1","3","0","1","1","1","0","0","0","0","0","1","0"
"Rodri","ESP","MF","Manchester City","0.8","2","1","1","1","0","0","0","0","1","0","1","1","1","0"
"Guido Rodríguez","ARG","MF","West Ham","12.8","36","19","21","15","0","17","33","16","23","9","14","13","35","1"
"Mads Roerslev","DEN","DF","Brentford","12.2","18","8","14","3","1","11","28","17","12","5","7","4","35","0"
"Morgan Rogers","ENG","FW,MF","Aston Villa","34.6","43","22","15","15","13","24","47","23","26","7","19","6","20","2"
"Cristian Romero","ARG","DF","Tottenham","15.7","35","29","26","8","1","21","30","9","18","3","15","21","57","2"
"Georginio Rutter","FRA","MF,FW","Brighton","18.4","39","15","13","18","8","14","36","22","20","3","17","10","13","2"
"José Sá","POR","GK","Wolves","29.0","2","2","2","0","0","2","2","0","0","0","0","0","15","1"
"Bukayo Saka","ENG","FW,MF","Arsenal","19.2","29","15","9","11","9","13","24","11","22","0","22","3","8","0"
"Mohamed Salah","EGY","FW","Liverpool","37.5","21","11","7","5","9","8","17","9","12","0","12","9","5","0"
"William Saliba","FRA","DF","Arsenal","33.8","62","37","37","23","2","21","28","7","25","15","10","21","119","7"
"Robert Sánchez","ESP","GK","Chelsea","32.0","0","0","0","0","0","0","1","1","0","0","0","2","24","10"
"Jadon Sancho","ENG","FW","Chelsea","19.6","13","7","3","3","7","5","12","7","11","0","11","2","8","2"
"Ibrahim Sangaré","CIV","MF","Nott'ham Forest","6.6","28","14","8","17","3","8","17","9","10","4","6","6","13","1"
"Pablo Sarabia","ESP","MF,FW","Wolves","9.0","16","8","4","8","4","10","16","6","10","0","10","4","7","1"
"Jeremy Sarmiento","ECU","MF","Brighton","0.1","0","0","0","0","0","0","0","0","0","0","0","0","0","0"
"Ismaila Sarr","SEN","MF","Crystal Palace","30.1","22","10","10","9","3","8","25","17","27","8","19","9","40","0"
"Sávio","BRA","FW,MF","Manchester City","19.6","23","17","5","10","8","10","19","9","14","2","12","6","9","1"
"Oliver Scarles","ENG","DF,FW","West Ham","7.4","21","11","17","3","1","14","22","8","14","2","12","11","26","0"
"Dane Scarlett","ENG","FW,MF","Tottenham","0.4","1","0","0","1","0","0","0","0","0","0","0","0","1","0"
"Kevin Schade","GER","FW","Brentford","25.5","39","25","17","10","12","13","23","10","19","4","15","5","34","0"
"Fabian Schär","SUI","DF","Newcastle Utd","32.6","36","21","16","18","2","14","35","21","38","25","13","45","138","3"
"Jeffrey Schlupp","GHA","MF,DF","Crystal Palace","1.1","2","0","1","0","1","0","3","3","6","0","6","0","2","0"
"Alex Scott","ENG","MF","Bournemouth","8.4","27","14","11","8","8","19","42","23","17","4","13","10","15","0"
"Matz Sels","BEL","GK","Nott'ham Forest","38.0","1","1","1","0","0","1","1","0","0","0","0","0","26","1"
"Nélson Semedo","POR","DF","Wolves","32.1","62","36","32","21","9","34","57","23","32","10","22","23","104","3"
"Antoine Semenyo","GHA","FW","Bournemouth","35.6","55","35","17","25","13","16","43","27","67","9","58","11","39","2"
"Marcos Senesi","ARG","DF","Bournemouth","12.3","39","21","23","14","2","14","31","17","16","7","9","14","58","0"
"Ryan Sessegnon","ENG","FW,DF","Fulham","6.4","27","13","11","11","5","9","20","11","13","1","12","3","18","0"
"Luke Shaw","ENG","DF","Manchester Utd","3.9","4","3","2","2","0","2","2","0","6","1","5","2","7","0"
"Zain Silcott-Duberry","MSR","FW","Bournemouth","0.0","1","1","0","0","1","1","1","0","0","0","0","0","0","0"
"Bernardo Silva","POR","MF,FW","Manchester City","29.7","56","37","17","30","9","25","56","31","36","7","29","23","32","3"
"Jota Silva","POR","FW,MF","Nott'ham Forest","9.5","27","14","12","13","2","6","27","21","9","1","8","12","17","0"
"Eric da Silva Moreira","GER","MF,DF","Nott'ham Forest","0.3","2","2","2","0","0","2","6","4","0","0","0","1","0","0"
"Jahmai Simpson-Pusey","ENG","DF","Manchester City","1.1","1","0","1","0","0","0","1","1","1","1","0","0","2","0"
"Luis Sinisterra","COL","FW,MF","Bournemouth","2.6","7","2","3","2","2","0","4","4","3","0","3","1","8","0"
"Oliver Skipp","ENG","MF","Leicester City","12.5","21","4","6","12","3","9","15","6","23","7","16","11","11","2"
"William Smallbone","IRL","MF","Southampton","7.7","20","13","9","9","2","7","22","15","8","0","8","2","14","2"
"Adam Smith","ENG","DF","Bournemouth","17.7","24","12","11","7","6","14","27","13","13","5","8","15","49","1"
"Emile Smith Rowe","ENG","MF","Fulham","22.7","31","18","7","14","10","8","24","16","22","2","20","11","16","0"
"Dominic Solanke","ENG","FW","Tottenham","24.5","18","11","1","12","5","4","16","12","20","9","11","1","23","0"
"Carlos Soler","ESP","MF,FW","West Ham","15.7","16","11","9","6","1","7","23","16","19","6","13","8","21","2"
"Julio Soler","ARG","DF,FW","Bournemouth","0.1","1","1","1","0","0","1","1","0","1","0","1","0","0","0"
"Ramón Sosa","PAR","FW,MF","Nott'ham Forest","3.3","5","3","3","0","2","1","5","4","9","0","9","4","5","0"
"Tomáš Souček","CZE","MF","West Ham","28.5","46","21","20","23","3","26","44","18","41","21","20","20","85","1"
"Boubakary Soumaré","FRA","MF","Leicester City","24.1","37","20","24","12","1","21","33","12","22","10","12","27","34","4"
"Djed Spence","ENG","DF","Tottenham","19.9","47","34","25","15","7","23","30","7","28","9","19","21","74","2"
"Jay Stansfield","ENG","MF","Fulham","0.0","0","0","0","0","0","0","0","0","0","0","0","0","0","0"
"Jason Steele","ENG","GK","Brighton","2.0","0","0","0","0","0","0","0","0","0","0","0","0","1","0"
"Jack Stephens","ENG","DF","Southampton","15.4","34","20","25","9","0","17","30","13","20","13","7","13","53","2"
"Raheem Sterling","ENG","FW,MF","Arsenal","5.5","9","4","1","3","5","5","10","5","3","0","3","1","4","0"
"Ross Stewart","SCO","FW","Southampton","4.3","6","4","1","1","4","3","8","5","3","0","3","1","7","0"
"Jakub Stolarczyk","POL","GK","Leicester City","10.0","2","1","2","0","0","1","2","1","0","0","0","0","6","1"
"John Stones","ENG","DF,MF","Manchester City","6.1","6","2","3","2","1","5","5","0","5","3","2","4","19","1"
"Jørgen Strand Larsen","NOR","FW","Wolves","28.7","10","6","2","3","5","4","27","23","19","4","15","6","29","0"
"Yukinari Sugawara","JPN","DF,MF","Southampton","17.3","31","18","16","14","1","19","31","12","21","10","11","11","53","3"
"Kamaldeen Sulemana","GHA","FW,MF","Southampton","15.6","22","17","9","5","8","10","15","5","16","4","12","6","9","0"
"Crysencio Summerville","NED","FW,MF","West Ham","8.7","13","7","2","8","3","3","9","6","13","4","9","0","7","0"
"Sammie Szmodics","IRL","FW,MF","Ipswich Town","11.0","16","10","4","10","2","7","26","19","10","2","8","6","14","0"
"Dominik Szoboszlai","HUN","MF","Liverpool","27.7","38","20","14","19","5","17","45","28","39","5","34","9","19","2"
"Matt Targett","ENG","DF","Newcastle Utd","0.2","0","0","0","0","0","0","1","1","0","0","0","1","1","0"
"James Tarkowski","ENG","DF","Everton","32.5","64","40","39","22","3","24","39","15","57","42","15","41","213","4"
"Marcus Tavernier","ENG","FW,MF","Bournemouth","21.5","43","24","15","19","9","10","27","17","16","3","13","5","11","0"
"Charlie Taylor","ENG","DF","Southampton","4.0","7","5","4","3","0","5","7","2","8","5","3","5","31","1"
"Jack Taylor","IRL","MF","Ipswich Town","9.6","20","10","6","11","3","12","27","15","12","3","9","9","24","0"
"Mathys Tel","FRA","FW","Tottenham","10.1","16","6","5","6","5","5","13","8","8","1","7","2","8","2"
"Kenny Tete","NED","DF","Fulham","19.7","56","38","29","14","13","23","38","15","31","12","19","32","67","0"
"Thiago","BRA","FW,MF","Brentford","1.9","5","3","2","1","2","0","1","1","3","0","3","2","3","1"
"Luke Thomas","ENG","DF","Leicester City","12.3","31","25","23","5","3","21","41","20","15","6","9","21","49","1"
"Youri Tielemans","BEL","MF","Aston Villa","33.6","84","58","32","44","8","40","73","33","38","16","22","23","47","4"
"Kieran Tierney","SCO","DF,FW","Arsenal","2.9","7","5","4","1","2","4","6","2","0","0","0","3","9","0"
"Jurriën Timber","NED","DF","Arsenal","26.9","58","38","17","30","11","18","27","9","19","4","15","22","44","1"
"Jean-Clair Todibo","FRA","DF","West Ham","20.3","47","28","30","15","2","26","36","10","25","13","12","26","83","3"
"Harry Toffolo","ENG","DF","Nott'ham Forest","1.5","5","3","3","1","1","3","4","1","2","2","0","2","12","0"
"Takehiro Tomiyasu","JPN","DF","Arsenal","0.1","0","0","0","0","0","0","0","0","0","0","0","0","1","0"
"Sandro Tonali","ITA","MF","Newcastle Utd","29.2","51","32","22","23","6","25","51","26","34","11","23","34","33","2"
"Pau Torres","ESP","DF","Aston Villa","22.4","21","15","11","8","2","10","17","7","16","11","5","10","75","2"
"Conor Townsend","ENG","DF","Ipswich Town","3.7","11","8","9","2","0","8","11","3","8","6","2","4","16","0"
"Adama Traoré","ESP","FW,MF","Fulham","19.7","20","13","9","6","5","5","13","8","7","0","7","1","6","4"
"Boubacar Traoré","MLI","MF","Wolves","0.0","2","0","0","2","0","1","1","0","0","0","0","0","0","0"
"Mark Travers","IRL","GK","Bournemouth","5.0","0","0","0","0","0","0","0","0","0","0","0","0","5","0"
"Ryan Trevitt","ENG","MF","Brentford","0.0","1","1","1","0","0","0","0","0","0","0","0","0","0","0"
"Kieran Trippier","ENG","DF","Newcastle Utd","14.5","38","21","18","14","6","22","36","14","11","3","8","12","49","0"
"Leandro Trossard","BEL","FW","Arsenal","28.3","31","20","6","16","9","12","34","22","32","0","32","9","18","0"
"Kostas Tsimikas","GRE","DF","Liverpool","9.3","31","20","15","11","5","14","23","9","5","2","3","11","20","0"
"Axel Tuanzebe","COD","DF","Ipswich Town","19.0","31","19","21","4","6","17","26","9","21","10","11","23","56","1"
"Destiny Udogie","ITA","DF","Tottenham","21.4","75","47","42","26","7","33","48","15","40","6","34","22","36","1"
"Manuel Ugarte Ribeiro","URU","MF","Manchester Utd","19.8","77","49","34","34","9","30","68","38","33","4","29","27","17","2"
"Lesley Ugochukwu","FRA","MF","Southampton","18.4","50","24","16","30","4","18","36","18","27","10","17","14","23","2"
"Enes Ünal","TUR","FW,MF","Bournemouth","3.8","1","0","0","0","1","0","3","3","1","0","1","0","6","0"
"Virgil van Dijk","NED","DF","Liverpool","37.0","38","20","17","19","2","13","22","9","27","16","11","56","190","4"
"Jamie Vardy","ENG","FW","Leicester City","31.4","19","13","7","7","5","4","13","9","8","4","4","5","24","0"
"Renato Veiga","POR","DF,MF","Chelsea","2.0","9","6","6","3","0","4","12","8","3","1","2","1","2","0"
"Joël Veltman","NED","DF","Brighton","18.9","43","29","24","16","3","31","52","21","22","7","15","19","66","0"
"Micky van de Ven","NED","DF","Tottenham","11.3","10","6","5","4","1","8","14","6","12","8","4","10","39","1"
"Bart Verbruggen","NED","GK","Brighton","36.0","0","0","0","0","0","0","3","3","1","0","1","0","29","5"
"Jannik Vestergaard","DEN","DF","Leicester City","15.5","22","10","16","6","0","9","15","6","21","14","7","16","74","1"
"Guglielmo Vicario","ITA","GK","Tottenham","24.0","0","0","0","0","0","0","0","0","0","0","0","1","14","6"
"Carlos Vinícius","BRA","MF,FW","Fulham","0.2","0","0","0","0","0","0","1","1","1","0","1","0","0","0"
"Kyle Walker","ENG","DF","Manchester City","10.8","17","10","7","7","3","14","26","12","13","4","9","3","13","1"
"Kyle Walker-Peters","ENG","DF","Southampton","32.4","44","29","22","15","7","16","35","19","27","15","12","19","90","1"
"Christian Walton","ENG","GK","Ipswich Town","7.0","0","0","0","0","0","0","1","1","0","0","0","0","2","1"
"Aaron Wan-Bissaka","ENG","DF","West Ham","35.0","70","49","33","32","5","23","32","9","37","11","26","66","125","0"
"Danny Ward","WAL","GK","Leicester City","1.5","0","0","0","0","0","0","0","0","0","0","0","0","1","0"
"Joel Ward","ENG","DF","Crystal Palace","0.8","2","0","0","2","0","0","0","0","0","0","0","0","3","0"
"James Ward-Prowse","ENG","MF","West Ham","11.5","20","14","8","8","4","7","19","12","6","3","3","8","15","0"
"James Ward-Prowse","ENG","MF","Nott'ham Forest","4.4","4","1","1","3","0","2","2","0","3","2","1","5","8","0"
"Ollie Watkins","ENG","FW","Aston Villa","28.9","10","7","0","6","4","3","11","8","11","3","8","8","15","2"
"Adam Webster","ENG","DF","Brighton","9.9","10","6","5","4","1","6","14","8","16","9","7","20","41","2"
"Danny Welbeck","ENG","FW","Brighton","23.5","26","16","6","15","5","8","20","12","19","4","15","5","14","0"
"Welington","BRA","DF","Southampton","5.4","21","9","15","5","1","12","19","7","5","1","4","7","36","0"
"Timo Werner","GER","FW,MF","Tottenham","5.7","6","4","3","3","0","3","13","10","10","1","9","1","7","0"
"Adam Wharton","ENG","MF","Crystal Palace","14.6","34","14","14","16","4","17","44","27","11","2","9","20","27","0"
"Ben White","ENG","DF","Arsenal","13.3","20","14","10","4","6","16","38","22","10","8","2","16","44","0"
"Mats Wieffer","NED","DF,MF","Brighton","11.3","58","34","27","27","4","32","47","15","18","2","16","17","28","3"
"Neco Williams","WAL","DF","Nott'ham Forest","28.8","90","57","63","19","8","53","86","33","42","10","32","31","137","3"
"Willian","BRA","FW,MF","Fulham","2.9","4","2","0","3","1","2","6","4","0","0","0","1","1","0"
"Joe Willock","ENG","MF,FW","Newcastle Utd","12.1","30","17","15","12","3","18","31","13","24","6","18","6","7","0"
"Callum Wilson","ENG","FW","Newcastle Utd","4.1","2","2","0","1","1","0","2","2","2","0","2","1","1","0"
"Harry Wilson","WAL","FW,MF","Fulham","12.9","20","14","13","3","4","12","18","6","15","1","14","7","10","1"
"Harry Winks","ENG","MF","Leicester City","17.1","24","11","12","10","2","13","30","17","19","7","12","9","20","0"
"Ben Winterburn","ENG","MF,FW","Bournemouth","0.3","0","0","0","0","0","0","1","1","0","0","0","2","0","0"
"Yoane Wissa","COD","FW","Brentford","32.4","22","12","6","8","8","11","27","16","29","8","21","8","21","3"
"Chris Wood","NZL","FW","Nott'ham Forest","32.9","6","5","2","2","2","3","11","8","12","7","5","5","29","1"
"Nathan Wood-Gordon","ENG","DF","Southampton","8.6","14","8","8","5","1","8","11","3","9","6","3","5","39","2"
"Luke Woolfenden","ENG","DF","Ipswich Town","13.2","9","6","5","4","0","2","5","3","21","14","7","19","76","0"
"Yehor Yarmoliuk","UKR","MF","Brentford","16.1","49","28","21","21","7","28","55","27","26","9","17","13","33","0"
"Ryan Yates","ENG","MF","Nott'ham Forest","21.3","42","21","24","14","4","17","37","20","38","10","28","26","61","1"
"Leny Yoro","FRA","DF","Manchester Utd","12.9","29","11","19","9","1","13","19","6","5","3","2","18","43","0"
"Ashley Young","ENG","DF","Everton","20.8","58","33","25","25","8","35","57","22","14","4","10","25","64","2"
"Illia Zabarnyi","UKR","DF","Bournemouth","34.5","52","36","31","20","1","34","50","16","33","20","13","41","182","2"
"Oleksandr Zinchenko","UKR","DF,MF","Arsenal","5.9","6","1","1","3","2","3","8","5","8","1","7","5","10","0"
"Joshua Zirkzee","NED","FW,MF","Manchester Utd","15.6","14","8","3","8","3","5","10","5","15","4","11","6","8","1"
"Martin Ødegaard","NOR","MF","Arsenal","25.8","19","11","9","7","3","4","25","21","5","0","5","6","6","1"
"Junior Adamu","AUT","FW","Freiburg","17.2","9","3","3","3","3","3","11","8","14","0","14","12","20","0"
"Karim Adeyemi","GER","FW,MF","Dortmund","15.9","20","14","6","6","8","8","20","12","14","1","13","7","5","0"
"Amine Adli","MAR","MF,FW","Leverkusen","8.5","15","9","4","2","9","4","11","7","11","0","11","0","4","0"
"Oladapo Afolayan","ENG","FW,MF","St. Pauli","18.2","17","8","4","8","5","7","19","12","17","1","16","8","20","0"
"Felix Agu","NGA","DF","Werder Bremen","19.5","30","14","12","14","4","12","23","11","27","9","18","21","48","0"
"Erik Ahlstrand","SWE","FW,MF","St. Pauli","0.5","0","0","0","0","0","0","0","0","1","0","1","1","1","0"
"Kevin Akpoguma","NGA","DF","Hoffenheim","24.7","54","27","36","12","6","30","46","16","65","37","28","29","115","1"
"Andreas Albers","DEN","FW","St. Pauli","0.7","1","1","0","0","1","0","1","1","0","0","0","0","1","0"
"Ben Alexander Voll","GER","GK","St. Pauli","1.0","0","0","0","0","0","0","0","0","0","0","0","0","0","0"
"Skelly Alvero","FRA","MF","Werder Bremen","2.6","11","6","5","5","1","4","5","1","4","0","4","2","10","0"
"Aurele Amenda","SUI","DF","Eint Frankfurt","1.1","1","0","1","0","0","0","0","0","2","2","0","2","11","0"
"Nadiem Amiri","GER","MF","Mainz 05","27.5","50","23","13","28","9","19","46","27","19","4","15","16","30","2"
"Mohamed Amoura","ALG","FW","Wolfsburg","27.4","29","22","14","5","10","14","37","23","42","2","40","9","24","0"
"Robert Andrich","GER","MF,DF","Leverkusen","17.8","24","12","8","14","2","7","14","7","16","8","8","29","23","0"
"Waldemar Anton","GER","DF","Dortmund","21.7","34","21","18","10","6","17","23","6","33","16","17","30","112","1"
"Maximilian Arnold","GER","MF","Wolfsburg","26.2","34","20","13","18","3","15","33","18","21","11","10","24","70","2"
"Jann-Fiete Arp","GER","FW,MF","Holstein Kiel","7.9","13","10","5","2","6","4","13","9","6","0","6","3","8","1"
"Arthur","BRA","DF","Leverkusen","8.4","14","11","3","9","2","5","10","5","8","0","8","9","29","0"
"Noah Atubolu","GER","GK","Freiburg","25.6","0","0","0","0","0","0","0","0","0","0","0","0","13","4"
"Ayman Azhil","MAR","MF","Dortmund","0.3","1","1","1","0","0","0","0","0","0","0","0","0","0","0"
"Adam Aznou","MAR","DF","Bayern Munich","0.2","0","0","0","0","0","0","0","0","0","0","0","0","1","0"
"Aliou Badara Baldé","GUI","MF,FW","Bochum","1.0","1","1","1","0","0","0","0","0","2","0","2","0","0","0"
"Ridle Baku","GER","FW,MF","Wolfsburg","13.0","23","15","9","9","5","8","19","11","22","1","21","15","15","0"
"Ridle Baku","GER","DF,MF","RB Leipzig","14.2","24","19","9","13","2","9","23","14","18","2","16","9","45","0"
"Samuel Bamba","GER","FW,MF","Bochum","0.3","1","1","1","0","0","0","0","0","0","0","0","0","0","0"
"Noahkai Banks","USA","DF","Augsburg","3.1","11","5","6","4","1","3","7","4","4","1","3","5","28","0"
"Scott Banks","SCO","FW,MF","St. Pauli","1.3","1","1","1","0","0","0","2","2","0","0","0","2","2","0"
"Aymen Barkok","MAR","MF","Mainz 05","0.8","2","1","1","1","0","1","1","0","1","1","0","2","0","0"
"Michy Batshuayi","BEL","FW","Eint Frankfurt","3.3","1","1","1","0","0","1","1","0","2","0","2","1","0","0"
"Maximilian Bauer","GER","DF","Augsburg","7.3","14","8","5","7","2","9","14","5","10","4","6","6","35","1"
"Oliver Baumann","GER","GK","Hoffenheim","28.0","2","2","2","0","0","2","4","2","0","0","0","0","15","2"
"Christoph Baumgartner","AUT","MF","RB Leipzig","17.9","44","28","13","19","12","17","42","25","45","9","36","12","24","2"
"Ihlas Bebou","TOG","MF","Hoffenheim","0.1","0","0","0","0","0","0","0","0","0","0","0","0","0","0"
"Adrian Beck","GER","MF,FW","Heidenheim","17.8","36","17","18","12","6","12","35","23","31","2","29","9","17","0"
"Timo Becker","GER","DF","Holstein Kiel","27.2","53","33","39","9","5","34","46","12","30","17","13","17","110","1"
"Hannes Behrens","GER","DF","Hoffenheim","0.3","1","1","0","1","0","0","0","0","1","0","1","2","0","0"
"Kevin Behrens","GER","FW","Wolfsburg","1.9","1","1","0","1","0","0","1","1","0","0","0","1","2","0"
"Maximilian Beier","GER","FW,MF","Dortmund","17.7","25","16","8","11","6","12","31","19","15","1","14","7","14","1"
"Stefan Bell","GER","DF","Mainz 05","16.0","22","12","16","6","0","9","14","5","16","14","2","28","107","1"
"Jeanuël Belocian","FRA","DF,MF","Leverkusen","0.8","1","1","1","0","0","1","1","0","0","0","0","0","2","0"
"László Bénes","SVK","MF,FW","Union Berlin","6.5","2","2","1","1","0","1","3","2","5","1","4","3","9","0"
"Ramy Bensebaini","ALG","DF","Dortmund","22.5","51","25","25","18","8","33","51","18","42","9","33","33","86","1"
"Mergim Berisha","GER","FW,MF","Hoffenheim","3.7","3","3","1","2","0","0","3","3","2","1","1","0","3","0"
"Mergim Berisha","GER","FW","Augsburg","0.4","1","0","0","1","0","1","1","0","2","1","1","0","0","0"
"Bernardo","BRA","DF","Bochum","19.8","46","28","32","13","1","27","37","10","38","17","21","26","103","4"
"Alexander Bernhardsson","SWE","FW,MF","Holstein Kiel","14.0","29","15","9","9","11","20","31","11","14","0","14","5","25","0"
"Matúš Bero","SVK","MF","Bochum","28.5","65","35","33","21","11","29","60","31","37","9","28","17","35","1"
"Jan-Niklas Beste","GER","FW,MF","Freiburg","2.4","2","1","0","1","1","1","7","6","3","0","3","1","7","0"
"El Bilal Touré","MLI","FW,MF","Stuttgart","4.0","4","1","1","1","2","3","3","0","1","0","1","0","1","0"
"Tom Bischof","GER","MF,FW","Hoffenheim","28.4","95","53","36","45","14","40","77","37","66","11","55","30","53","1"
"Leonardo Bittencourt","GER","MF","Werder Bremen","10.9","25","9","15","7","3","6","18","12","8","0","8","15","11","0"
"Myron Boadu","NED","FW","Bochum","11.6","2","1","0","0","2","1","5","4","3","0","3","1","4","0"
"Sacha Boey","FRA","DF","Bayern Munich","6.6","20","5","6","6","8","13","18","5","6","0","6","2","14","0"
"Victor Boniface","NGA","FW","Leverkusen","11.2","5","4","0","3","2","3","4","1","1","0","1","0","5","0"
"Sebastiaan Bornauw","BEL","DF","Wolfsburg","8.8","9","6","4","4","1","4","8","4","14","12","2","12","36","0"
"Carlo Boukhalfa","MAR","MF","St. Pauli","18.3","26","11","7","17","2","7","19","12","22","3","19","12","25","1"
"Julian Brandt","GER","MF","Dortmund","25.6","26","11","13","8","5","15","43","28","17","0","17","14","13","1"
"Tim Breithaupt","GER","MF","Augsburg","1.3","1","1","0","1","0","0","4","4","1","0","1","2","0","0"
"Maximilian Breunig","GER","FW,MF","Heidenheim","3.9","4","3","1","2","1","3","6","3","9","2","7","1","3","0"
"Moritz Broschinski","GER","FW,MF","Bochum","15.4","19","14","6","6","7","6","15","9","18","0","18","1","18","0"
"Nathaniel Brown","GER","DF,MF","Eint Frankfurt","21.6","71","42","39","18","14","44","55","11","30","0","30","15","55","1"
"Jacob Bruun Larsen","DEN","FW,MF","Hoffenheim","4.4","4","3","1","2","1","3","8","5","5","1","4","1","2","0"
"Jacob Bruun Larsen","DEN","MF,FW","Stuttgart","4.6","1","1","1","0","0","0","2","2","7","0","7","1","4","1"
"Emi Buendía","ARG","MF","Leverkusen","2.9","6","5","1","4","1","5","8","3","6","0","6","0","0","0"
"Marius Bülter","GER","FW,DF","Hoffenheim","19.2","13","10","5","6","2","9","17","8","10","3","7","4","14","1"
"Jonathan Burkardt","GER","FW","Mainz 05","23.4","15","8","1","7","7","6","10","4","11","1","10","1","14","0"
"Oliver Burke","SCO","FW","Werder Bremen","10.1","11","4","5","1","5","4","6","2","20","0","20","2","6","0"
"Marnon Busch","GER","DF,MF","Heidenheim","15.5","26","17","19","7","0","23","32","9","23","10","13","13","65","5"
"Anthony Caci","FRA","DF","Mainz 05","29.8","60","40","23","25","12","28","44","16","33","8","25","27","47","2"
"Cole Campbell","USA","MF,FW","Dortmund","0.2","0","0","0","0","0","0","0","0","0","0","0","0","1","0"
"Emre Can","GER","DF,MF","Dortmund","23.4","50","28","30","16","4","18","36","18","31","17","14","20","89","3"
"Tiago Cardoso","LUX","GK","Gladbach","4.2","1","0","1","0","0","1","1","0","0","0","0","0","2","2"
"Abdoulie Ceesay","GAM","FW","St. Pauli","0.7","3","3","1","1","1","2","3","1","2","0","2","0","1","0"
"Julian Chabot","GER","DF","Stuttgart","25.2","37","24","19","15","3","15","32","17","29","19","10","38","135","0"
"El Chadaille Bitshiabu","FRA","DF","RB Leipzig","12.6","27","18","17","9","1","10","19","9","25","14","11","13","97","2"
"Fares Chaïbi","ALG","MF,FW","Eint Frankfurt","11.3","13","9","4","5","4","7","20","13","10","0","10","10","32","1"
"Timothy Chandler","USA","DF","Eint Frankfurt","0.3","0","0","0","0","0","0","0","0","0","0","0","3","2","0"
"Anrie Chase","JPN","DF","Stuttgart","8.2","10","4","6","4","0","5","7","2","10","6","4","9","35","0"
"Arthur Chaves","BRA","DF","Hoffenheim","24.3","51","36","28","19","4","25","50","25","47","20","27","37","136","3"
"Fabio Chiarodia","ITA","DF","Gladbach","4.2","10","4","6","4","0","4","6","2","8","3","5","9","53","1"
"Carney Chukwuemeka","ENG","MF","Dortmund","2.8","7","5","3","2","2","1","1","0","5","0","5","1","1","0"
"Alexis Claude-Maurice","FRA","MF,FW","Augsburg","23.4","41","26","12","15","14","17","34","17","16","0","16","15","8","1"
"Nnamdi Collins","GER","DF","Eint Frankfurt","16.5","33","24","24","7","2","17","22","5","22","11","11","16","74","3"
"Kingsley Coman","FRA","FW","Bayern Munich","14.2","17","12","6","6","5","8","12","4","12","0","12","8","15","0"
"Sirlord Conteh","GER","FW,MF","Heidenheim","9.9","9","5","3","6","0","2","7","5","1","1","0","1","8","0"
"Danny da Costa","GER","DF","Mainz 05","22.3","42","23","23","15","4","17","27","10","19","10","9","27","95","3"
"Yan Couto","BRA","DF,FW","Dortmund","9.9","24","16","17","2","5","14","25","11","12","1","11","10","32","2"
"Tomáš Čvančara","CZE","FW","Gladbach","9.2","4","1","3","1","0","2","7","5","6","3","3","5","17","0"
"Finn Dahmen","GER","GK","Augsburg","19.0","1","0","1","0","0","1","2","1","0","0","0","0","9","0"
"Thomas Dähne","GER","GK","Holstein Kiel","9.0","0","0","0","0","0","0","0","0","0","0","0","0","7","2"
"Mahmoud Dahoud","GER","MF","Eint Frankfurt","4.0","9","4","4","5","0","4","6","2","5","1","4","2","5","0"
"Ameen Al-Dakhil","BEL","DF","Stuttgart","4.8","6","6","4","2","0","4","4","0","12","8","4","9","30","1"
"Bence Dárdai","HUN","MF","Wolfsburg","14.5","24","14","9","13","2","16","30","14","20","4","16","12","28","1"
"Lukas Daschner","GER","MF,FW","Bochum","4.6","4","2","1","2","1","2","9","7","5","0","5","0","5","0"
"Alphonso Davies","CAN","DF","Bayern Munich","17.3","30","17","7","17","6","17","26","9","14","1","13","13","22","2"
"Olivier Deman","BEL","DF","Werder Bremen","0.7","6","3","2","4","0","2","7","5","3","1","2","3","4","0"
"Ermedin Demirović","BIH","FW","Stuttgart","20.6","12","7","3","4","5","3","12","9","14","3","11","3","12","0"
"Justin Diehl","GER","FW,DF","Stuttgart","1.2","1","0","0","1","0","1","1","0","2","0","2","0","0","0"
"Eric Dier","ENG","DF","Bayern Munich","16.3","19","11","8","9","2","13","20","7","19","8","11","20","77","1"
"Junior Dina Ebimbe","FRA","MF,FW","Eint Frankfurt","3.3","3","2","1","2","0","1","3","2","4","0","4","7","6","0"
"Eren Dinkçi","GER","MF,FW","Freiburg","13.3","21","13","8","8","5","7","23","16","22","2","20","7","7","0"
"Ritsu Doan","JPN","FW,MF","Freiburg","31.8","66","42","33","26","7","25","46","21","57","2","55","14","47","1"
"Danilho Doekhi","NED","DF","Union Berlin","34.0","37","24","18","16","3","13","23","10","35","16","19","44","169","1"
"Niklas Dorsch","GER","MF","Augsburg","0.4","0","0","0","0","0","0","0","0","1","0","1","0","0","0"
"Niklas Dorsch","GER","MF","Heidenheim","14.8","27","16","12","15","0","13","22","9","14","1","13","17","17","2"
"Patrick Drewes","GER","GK","Bochum","21.0","0","0","0","0","0","0","1","1","1","0","1","0","11","1"
"Tim Drexler","GER","DF","Hoffenheim","4.0","17","7","11","6","0","9","12","3","6","4","2","1","9","1"
"Marvin Ducksch","GER","FW","Werder Bremen","26.9","10","7","3","5","2","3","14","11","10","2","8","8","26","3"
"Julien Duranville","BEL","FW,MF","Dortmund","3.1","3","0","0","3","0","1","2","1","1","0","1","0","3","0"
"Adam Dźwigała","POL","DF,MF","St. Pauli","4.1","20","10","13","6","1","11","16","5","6","1","5","4","28","0"
"Johannes Eggestein","GER","FW","St. Pauli","20.6","5","3","0","2","3","1","5","4","5","0","5","0","8","0"
"Maximilian Eggestein","GER","MF","Freiburg","31.6","57","32","21","26","10","24","43","19","37","10","27","39","54","1"
"Hugo Ekitike","FRA","FW","Eint Frankfurt","28.5","16","12","3","8","5","4","12","8","13","1","12","7","24","0"
"Elif Elmas","MKD","MF","RB Leipzig","0.5","3","1","3","0","0","1","3","2","2","0","2","0","2","0"
"Nico Elvedi","SUI","DF","Gladbach","23.7","38","23","28","6","4","17","23","6","35","27","8","30","163","0"
"Arne Engels","BEL","MF,FW","Augsburg","0.9","0","0","0","0","0","0","0","0","1","1","0","0","0","0"
"Patrick Erras","GER","DF","Holstein Kiel","9.2","8","5","6","2","0","2","9","7","13","11","2","9","64","0"
"Samuel Essende","COD","FW","Augsburg","18.2","7","6","1","3","3","3","4","1","13","2","11","0","11","1"
"Frank Feller","GER","GK","Heidenheim","1.3","0","0","0","0","0","0","0","0","0","0","0","0","1","0"
"Kilian Fischer","GER","DF","Wolfsburg","25.5","64","44","48","12","4","47","89","42","41","8","33","19","98","2"
"Jonas Föhrenbach","GER","DF","Heidenheim","20.4","45","24","25","15","5","22","35","13","29","3","26","16","57","0"
"Marco Friedl","AUT","DF","Werder Bremen","24.0","62","42","35","26","1","38","66","28","41","24","17","34","130","1"
"Marvin Friedrich","GER","DF","Gladbach","11.0","15","9","12","3","0","9","16","7","16","12","4","5","57","0"
"Jeremie Frimpong","NED","DF,MF","Leverkusen","25.7","33","25","14","12","7","16","29","13","25","0","25","8","22","1"
"Chris Führich","GER","MF,FW","Stuttgart","22.0","15","10","5","5","5","13","27","14","23","2","21","6","19","0"
"Shiō Fukuda","JPN","FW","Gladbach","0.7","0","0","0","0","0","0","0","0","1","0","1","0","0","0"
"Cristian Gamboa","CRC","DF","Bochum","2.5","8","3","5","3","0","3","9","6","2","0","2","2","8","0"
"Aleix García","ESP","MF","Leverkusen","16.2","13","7","4","6","3","7","15","8","12","2","10","11","24","1"
"Viggo Gebel","GER","MF","RB Leipzig","0.2","0","0","0","0","0","0","0","0","0","0","0","0","0","0"
"Lutsharel Geertruida","NED","DF","RB Leipzig","17.3","35","24","24","11","0","15","31","16","15","4","11","16","59","4"
"Dennis Geiger","GER","MF,FW","Hoffenheim","8.2","24","11","9","13","2","12","19","7","15","2","13","7","6","1"
"Valentin Gendrey","FRA","DF","Hoffenheim","15.7","30","12","19","9","2","11","18","7","19","5","14","15","53","0"
"Yannick Gerhardt","GER","MF,DF","Wolfsburg","16.9","28","16","13","14","1","11","30","19","32","8","24","17","47","0"
"Max Geschwill","GER","DF","Holstein Kiel","14.2","26","21","13","12","1","14","19","5","14","9","5","30","53","1"
"Dimitris Giannoulis","GRE","DF","Augsburg","29.4","47","32","27","16","4","26","44","18","49","11","38","47","75","0"
"Armin Gigovic","BIH","MF","Holstein Kiel","21.1","25","13","14","8","3","5","21","16","20","1","19","21","33","0"
"Benedikt Gimber","GER","DF","Heidenheim","29.7","72","46","48","23","1","38","63","25","53","19","34","31","131","1"
"Matthias Ginter","GER","DF","Freiburg","28.5","30","17","15","11","4","15","28","13","35","23","12","19","146","5"
"Jamie Gittens","ENG","FW,MF","Dortmund","19.7","31","19","12","12","7","14","18","4","16","0","16","10","4","0"
"Serge Gnabry","GER","FW,MF","Bayern Munich","13.8","20","11","6","7","7","8","12","4","11","0","11","6","9","0"
"Tidiam Gomis","FRA","MF,FW","RB Leipzig","1.7","0","0","0","0","0","0","0","0","2","0","2","1","0","0"
"Leon Goretzka","GER","MF,DF","Bayern Munich","14.7","21","11","5","12","4","10","20","10","27","7","20","20","25","1"
"Robin Gosens","GER","DF","Union Berlin","1.0","0","0","0","0","0","0","3","3","1","0","1","1","2","0"
"Mario Götze","GER","MF,FW","Eint Frankfurt","17.1","41","28","18","20","3","15","36","21","15","1","14","7","8","0"
"Jeffrey Gouweleeuw","NED","DF","Augsburg","32.7","50","28","25","21","4","27","40","13","34","15","19","35","183","0"
"Kamil Grabara","POL","GK","Wolfsburg","28.7","0","0","0","0","0","0","2","2","1","0","1","0","16","2"
"Michael Gregoritsch","AUT","FW","Freiburg","7.1","4","2","1","0","3","1","5","4","2","1","1","1","10","0"
"Vincenzo Grifo","ITA","FW,MF","Freiburg","27.0","30","22","12","13","5","15","34","19","24","2","22","9","23","2"
"Florian Grillitsch","AUT","MF","Hoffenheim","6.7","15","9","5","9","1","8","14","6","6","2","4","8","18","0"
"Álex Grimaldo","ESP","DF","Leverkusen","29.3","24","14","13","7","4","16","42","26","22","3","19","16","43","3"
"Pascal Groß","GER","MF,DF","Dortmund","25.9","44","28","11","26","7","15","51","36","46","13","33","9","30","1"
"Marco Grüll","AUT","FW,MF","Werder Bremen","13.1","12","9","1","5","6","4","17","13","14","2","12","3","10","0"
"Raphaël Guerreiro","POR","DF,MF","Bayern Munich","17.5","19","12","9","7","3","12","16","4","9","0","9","10","19","1"
"Morgan Guilavogui","GUI","FW,MF","St. Pauli","20.1","32","17","11","16","5","14","31","17","28","0","28","13","33","0"
"Serhou Guirassy","GUI","FW","Dortmund","28.9","7","6","2","2","3","2","5","3","10","3","7","4","38","0"
"Péter Gulácsi","HUN","GK","RB Leipzig","29.2","1","1","1","0","0","1","2","1","0","0","0","0","16","4"
"Robert Gumny","POL","DF","Augsburg","3.0","3","3","1","2","0","2","6","4","2","0","2","1","6","0"
"Christian Günter","GER","DF","Freiburg","25.7","23","21","12","8","3","16","29","13","24","10","14","8","50","1"
"Janik Haberer","GER","MF,DF","Union Berlin","18.8","39","29","16","21","2","26","44","18","16","0","16","17","37","0"
"Robin Hack","GER","FW,MF","Gladbach","24.1","22","17","11","8","3","12","28","16","30","2","28","9","28","0"
"Amadou Haidara","MLI","MF","RB Leipzig","14.7","30","17","12","16","2","12","29","17","42","12","30","18","56","1"
"Andreas Hanche-Olsen","NOR","DF","Mainz 05","14.3","21","13","12","8","1","9","12","3","25","18","7","12","85","2"
"Phil Harres","GER","FW","Holstein Kiel","17.2","10","10","3","4","3","4","8","4","17","3","14","5","20","0"
"Ramon Hendriks","NED","DF","Stuttgart","12.8","20","9","11","7","2","9","13","4","15","7","8","19","63","0"
"Paul Hennrich","GER","MF","Hoffenheim","0.1","0","0","0","0","0","0","0","0","1","1","0","0","0","0"
"Benjamin Henrichs","GER","DF","RB Leipzig","10.4","32","16","18","10","4","14","27","13","22","3","19","15","33","0"
"Mario Hermoso","ESP","DF","Leverkusen","3.3","0","0","0","0","0","0","0","0","3","1","2","9","15","1"
"Piero Hincapié","ECU","DF","Leverkusen","29.7","52","40","27","15","10","25","41","16","40","20","20","32","114","1"
"Adam Hložek","CZE","FW,MF","Hoffenheim","20.8","22","10","7","8","7","11","20","9","13","1","12","4","20","0"
"Nicolas Höfler","GER","MF","Freiburg","8.8","33","23","13","18","2","20","31","11","7","1","6","14","28","1"
"Jonas Hofmann","GER","MF,DF","Leverkusen","4.0","2","0","0","2","0","1","4","3","2","0","2","0","3","0"
"Philipp Hofmann","GER","FW","Bochum","25.3","17","12","4","6","7","8","15","7","14","1","13","4","33","0"
"Lucas Höler","GER","FW,MF","Freiburg","20.7","37","24","18","15","4","9","24","15","29","7","22","7","36","0"
"Benedict Hollerbach","GER","FW,MF","Union Berlin","28.2","43","22","8","23","12","21","51","30","35","0","35","2","13","1"
"Lewis Holtby","GER","MF","Holstein Kiel","13.8","34","20","19","10","5","12","28","16","14","2","12","21","26","3"
"Gerrit Holtmann","PHI","DF,FW","Bochum","12.6","24","19","14","8","2","12","24","12","18","5","13","16","15","0"
"Franck Honorat","FRA","FW","Gladbach","16.0","17","7","10","4","3","2","8","6","9","1","8","5","28","1"
"Mathias Honsak","AUT","FW,DF","Heidenheim","13.1","15","8","10","5","0","10","23","13","19","4","15","10","31","0"
"Timo Horn","GER","GK","Bochum","13.0","0","0","0","0","0","0","0","0","0","0","0","0","9","2"
"Lukáš Hrádecký","FIN","GK","Leverkusen","29.0","0","0","0","0","0","0","1","1","0","0","0","0","8","2"
"Robin Hranáč","CZE","DF","Hoffenheim","2.4","0","0","0","0","0","0","1","1","3","2","1","5","9","1"
"Hong Hyunseok","KOR","MF","Mainz 05","5.9","8","3","3","3","2","1","4","3","7","1","6","7","9","0"
"Oscar Højlund","DEN","MF","Eint Frankfurt","8.0","21","12","8","9","4","8","16","8","15","7","8","5","11","1"
"Arijon Ibrahimović","GER","FW","Bayern Munich","0.0","0","0","0","0","0","0","0","0","0","0","0","0","0","0"
"Andrej Ilic","SRB","FW","Union Berlin","10.4","2","2","0","2","0","0","6","6","7","3","4","5","6","1"
"Jackson Irvine","AUS","MF","St. Pauli","29.0","56","28","24","26","6","25","45","20","27","5","22","36","63","2"
"Ko Itakura","JPN","DF","Gladbach","31.0","40","29","23","16","1","21","34","13","41","22","19","28","171","0"
"Hiroki Ito","JPN","DF","Bayern Munich","2.8","2","0","1","1","0","1","1","0","3","2","1","6","15","1"
"Marko Ivezić","SRB","DF","Holstein Kiel","18.4","29","19","20","6","3","15","42","27","25","13","12","27","103","2"
"Lee Jae-sung","KOR","MF","Mainz 05","29.4","42","21","16","19","7","15","39","24","39","3","36","35","38","0"
"Kristijan Jakić","CRO","MF","Augsburg","25.6","46","23","20","19","7","22","43","21","42","9","33","28","50","1"
"Luca Jaquez","SUI","DF","Stuttgart","2.8","3","0","3","0","0","1","3","2","2","0","2","3","4","0"
"Dominik Javorček","SVK","DF,MF","Holstein Kiel","4.3","3","0","3","0","0","1","5","4","7","3","4","5","26","1"
"Finn Jeltsch","GER","DF","Stuttgart","8.7","18","13","6","11","1","12","15","3","12","6","6","13","27","2"
"Fredrik Jensen","FIN","MF","Augsburg","8.5","7","7","1","3","3","4","5","1","10","1","9","4","17","0"
"Moritz Jenz","GER","DF","Mainz 05","17.8","36","20","18","18","0","16","21","5","23","14","9","30","128","2"
"Carl Johansson","SWE","DF","Holstein Kiel","6.3","4","2","4","0","0","3","7","4","12","8","4","10","54","1"
"Anthony Jung","GER","DF","Werder Bremen","21.1","34","22","22","11","1","22","34","12","23","14","9","25","77","1"
"Josip Juranović","CRO","DF,MF","Union Berlin","12.9","21","13","12","6","3","10","25","15","13","6","7","7","42","2"
"David Jurásek","CZE","DF","Hoffenheim","6.9","6","3","3","2","1","2","5","3","5","0","5","6","17","0"
"Yusuf Kabadayı","GER","FW,MF","Augsburg","0.8","1","0","0","1","0","0","0","0","1","0","1","0","0","0"
"Almugera Kabar","GER","DF","Dortmund","1.5","5","3","2","2","1","3","3","0","1","0","1","1","4","0"
"Issa Kaboré","BFA","DF,FW","Werder Bremen","3.4","8","4","2","5","1","4","6","2","8","2","6","2","7","0"
"Pavel Kadeřábek","CZE","DF","Hoffenheim","17.5","25","14","14","4","7","15","31","16","13","3","10","20","54","1"
"Jakub Kamiński","POL","DF,MF","Wolfsburg","12.6","17","8","8","3","6","9","22","13","17","7","10","13","23","1"
"Kevin Kampl","SVN","MF","RB Leipzig","17.7","27","18","11","10","6","16","26","10","25","6","19","24","25","0"
"Harry Kane","ENG","FW","Bayern Munich","26.5","13","11","3","8","2","2","6","4","16","2","14","2","16","0"
"Atakan Karazor",NA,"MF","Stuttgart","29.1","59","29","19","28","12","29","57","28","39","7","32","32","51","1"
"Mikkel Kaufmann","DEN","FW","Heidenheim","4.1","6","4","1","3","2","2","5","3","5","2","3","2","7","0"
"Yannik Keitel","GER","MF","Stuttgart","3.0","9","6","3","5","1","9","10","1","5","2","3","4","6","0"
"Andu Kelati","GER","MF,DF","Holstein Kiel","3.2","7","4","2","4","1","2","5","3","4","1","3","3","3","0"
"Thomas Keller","GER","DF,MF","Heidenheim","1.6","6","5","5","1","0","4","6","2","3","1","2","4","11","0"
"Aljoscha Kemlein","GER","MF","Union Berlin","10.2","10","4","4","5","1","5","14","9","14","3","11","6","15","0"
"Luca Kerber","GER","MF,DF","Heidenheim","8.7","26","16","17","8","1","16","31","15","14","4","10","5","25","1"
"Rani Khedira","GER","MF","Union Berlin","30.3","68","40","30","35","3","24","38","14","33","11","22","44","55","0"
"Joshua Kimmich","GER","MF","Bayern Munich","31.6","47","29","11","29","7","30","50","20","23","3","20","25","34","3"
"Tim Kleindienst","GER","FW","Gladbach","30.4","30","15","6","15","9","10","35","25","45","9","36","12","66","1"
"Lukas Klostermann","GER","DF","RB Leipzig","20.4","27","14","18","7","2","14","24","10","31","17","14","24","143","3"
"Ansgar Knauff","GER","MF,DF","Eint Frankfurt","17.7","41","22","18","16","7","12","26","14","23","4","19","12","24","0"
"Magnus Knudsen","NOR","MF","Holstein Kiel","20.6","48","29","21","21","6","25","44","19","18","4","14","12","44","0"
"Gregor Kobel","SUI","GK","Dortmund","32.0","0","0","0","0","0","0","0","0","0","0","0","1","23","3"
"Robin Koch","GER","DF","Eint Frankfurt","28.7","24","11","14","8","2","10","22","12","39","25","14","25","197","4"
"Derrick Köhn","GER","DF,FW","Werder Bremen","14.9","20","10","7","10","3","10","14","4","21","4","17","10","26","0"
"Dominik Kohr","GER","DF,MF","Mainz 05","25.5","62","46","34","21","7","35","55","20","43","24","19","42","127","0"
"Marco Komenda","CRO","DF","Holstein Kiel","14.5","26","17","12","13","1","11","15","4","23","11","12","6","68","0"
"Mert Kömür","GER","MF","Augsburg","7.3","3","2","2","0","1","0","3","3","9","3","6","3","7","1"
"Kacper Koscierski","GER","DF","Bochum","0.1","0","0","0","0","0","0","0","0","0","0","0","0","0","0"
"Henri Koudossou","GER","DF","Augsburg","8.3","18","10","6","11","1","11","19","8","8","2","6","15","37","0"
"Konstantinos Koulierakis","GRE","DF","Wolfsburg","27.4","40","20","25","13","2","25","40","15","34","14","20","33","147","2"
"Matej Kovar","CZE","GK","Leverkusen","5.0","0","0","0","0","0","0","0","0","0","0","0","0","0","1"
"Andrej Kramarić","CRO","MF,FW","Hoffenheim","30.7","15","8","5","8","2","6","11","5","16","3","13","7","11","1"
"Frans Krätzig","GER","DF,MF","Heidenheim","13.5","32","18","14","12","6","12","21","9","12","1","11","17","15","0"
"Frans Krätzig","GER","DF","Stuttgart","0.6","2","1","1","0","1","1","3","2","2","1","1","0","1","0"
"Tom Krauß","GER","MF","Bochum","12.0","35","18","20","13","2","19","38","19","26","2","24","11","19","1"
"Rasmus Kristensen","DEN","DF","Eint Frankfurt","27.9","59","33","37","17","5","40","67","27","50","13","37","20","97","1"
"Lukas Kübler","GER","DF","Freiburg","20.5","40","21","17","20","3","27","48","21","32","13","19","53","61","3"
"Jonah Kusi-Asare","SWE","FW","Bayern Munich","0.0","1","0","0","0","1","0","0","0","0","0","0","0","0","0"
"Moritz-Broni Kwarteng","GHA","MF,FW","Bochum","1.9","4","3","1","1","2","1","2","1","0","0","0","0","1","0"
"Nediljko Labrović","CRO","GK","Augsburg","15.0","0","0","0","0","0","0","0","0","0","0","0","0","12","1"
"Konrad Laimer","AUT","DF","Bayern Munich","18.9","49","27","19","22","8","23","48","25","24","1","23","8","24","1"
"Stefan Lainer","AUT","DF","Gladbach","8.4","22","13","16","5","1","12","14","2","12","6","6","12","30","0"
"Hugo Larsson","SWE","MF","Eint Frankfurt","26.6","47","27","17","25","5","21","42","21","42","11","31","30","35","1"
"Diogo Leite","POR","DF","Union Berlin","28.3","64","32","43","17","4","33","50","17","61","25","36","57","162","1"
"Maxim Leitsch","GER","DF","Mainz 05","7.5","12","4","6","4","2","7","9","2","12","4","8","10","42","1"
"Jamie Leweling","GER","MF,FW","Stuttgart","18.5","16","6","6","3","7","11","25","14","22","1","21","11","17","1"
"Philipp Lienhart","AUT","DF","Freiburg","30.8","22","13","12","10","0","15","31","16","31","20","11","36","124","3"
"Marin Ljubicic","CRO","FW,MF","Union Berlin","3.1","2","1","0","2","0","1","3","2","2","0","2","0","7","0"
"Anthony Losilla","FRA","MF","Bochum","12.6","30","16","15","12","3","17","33","16","22","7","15","18","27","1"
"Yannik Lührs","GER","DF","Dortmund","1.4","1","1","1","0","0","0","0","0","0","0","0","2","4","0"
"Castello Lukeba","FRA","DF","RB Leipzig","17.5","31","17","15","12","4","17","24","7","29","12","17","17","74","0"
"Senne Lynen","BEL","MF","Werder Bremen","30.4","72","39","36","30","6","39","69","30","56","13","43","65","75","5"
"Shuto Machino","JPN","FW,MF","Holstein Kiel","21.7","8","5","4","3","1","6","16","10","12","3","9","7","28","1"
"Arne Maier","GER","MF","Augsburg","10.4","13","7","4","8","1","7","13","6","15","1","14","6","14","1"
"Patrick Mainka","GER","DF","Heidenheim","34.0","58","30","36","20","2","35","55","20","61","36","25","68","206","0"
"Lovro Majer","CRO","MF","Wolfsburg","3.4","2","1","0","1","1","1","5","4","5","1","4","1","2","1"
"Jordy Makengo","FRA","DF","Freiburg","8.3","16","9","10","5","1","10","16","6","8","3","5","7","29","0"
"Jarzinho Malanga","GER","DF","Stuttgart","0.0","0","0","0","0","0","0","0","0","0","0","0","0","0","0"
"Julián Malatini","ARG","DF","Werder Bremen","5.0","11","9","5","5","1","5","11","6","8","3","5","7","17","0"
"Donyell Malen","NED","FW,MF","Dortmund","6.8","0","0","0","0","0","0","2","2","2","0","2","3","6","0"
"Lennard Maloney","USA","MF","Heidenheim","8.4","20","11","12","7","1","14","23","9","9","2","7","14","38","0"
"Lennard Maloney","USA","MF","Mainz 05","0.3","2","1","0","1","1","1","1","0","2","0","2","0","3","0"
"Johan Manzambi","SUI","FW,MF","Freiburg","3.7","8","2","1","3","4","1","4","3","6","0","6","4","7","0"
"Omar Marmoush","EGY","FW","Eint Frankfurt","16.1","12","8","0","3","9","3","7","4","7","1","6","2","2","0"
"Giorgos Masouras","GRE","FW,MF","Bochum","11.7","18","10","6","7","5","7","16","9","9","1","8","4","3","1"
"Erhan Mašović","SRB","DF","Bochum","10.1","14","10","10","4","0","13","28","15","17","11","6","12","55","0"
"Igor Matanovic","CRO","FW","Eint Frankfurt","3.5","2","0","0","2","0","0","1","1","3","0","3","1","9","0"
"Chrislain Matsima","FRA","DF","Augsburg","28.3","31","20","19","11","1","17","26","9","48","29","19","52","163","0"
"Jean Mattéo Bahoya","FRA","MF,FW","Eint Frankfurt","10.2","29","18","11","13","5","16","26","10","14","2","12","4","10","1"
"Maurides","BRA","FW","St. Pauli","0.0","0","0","0","0","0","0","0","0","0","0","0","0","0","0"
"Keke Maximilian Topp","GER","FW,MF","Werder Bremen","2.8","3","1","0","2","1","1","2","1","0","0","0","1","4","0"
"Jakov Medić","CRO","DF","Bochum","17.8","13","11","9","3","1","8","18","10","32","21","11","22","111","4"
"Connor Metcalfe","AUS","MF,FW","St. Pauli","4.0","2","0","1","1","0","0","5","5","4","0","4","3","8","0"
"Karol Mets","EST","DF","St. Pauli","10.0","13","8","6","7","0","4","7","3","9","3","6","12","60","0"
"Alexander Meyer","GER","GK","Dortmund","2.0","0","0","0","0","0","0","0","0","0","0","0","0","0","0"
"Florian Micheler","AUT","MF","Hoffenheim","0.4","0","0","0","0","0","0","2","2","0","0","0","0","0","0"
"Enzo Millot","FRA","MF,FW","Stuttgart","20.5","30","13","10","15","5","12","35","23","27","0","27","13","6","1"
"Kim Min-jae","KOR","DF","Bayern Munich","25.4","35","20","18","13","4","11","21","10","23","10","13","37","91","4"
"Maximilian Mittelstädt","GER","DF","Stuttgart","27.4","79","54","42","30","7","53","73","20","47","11","36","47","96","2"
"Koji Miyoshi","JPN","FW,MF","Bochum","5.2","8","5","2","1","5","4","9","5","10","1","9","2","2","0"
"Max Moerstedt","GER","FW","Hoffenheim","5.0","5","5","1","3","1","1","2","1","4","0","4","0","5","0"
"David Mokwa","FRA","DF,FW","Hoffenheim","0.2","1","0","1","0","0","0","0","0","0","0","0","0","0","0"
"Steve Mounié","BEN","FW,MF","Augsburg","3.9","4","4","0","1","3","0","1","1","1","1","0","1","5","1"
"Nordi Mukiele","FRA","DF","Leverkusen","10.0","20","16","8","8","4","12","18","6","10","0","10","16","37","2"
"Florian Müller","GER","GK","Freiburg","8.4","0","0","0","0","0","0","0","0","0","0","0","0","3","0"
"Kevin Müller","GER","GK","Heidenheim","32.7","3","2","3","0","0","3","3","0","0","0","0","0","13","4"
"Marius Müller","GER","GK","Wolfsburg","5.3","0","0","0","0","0","0","0","0","0","0","0","0","0","0"
"Thomas Müller","GER","MF,FW","Bayern Munich","13.6","8","5","2","3","3","4","16","12","10","0","10","2","14","0"
"Jamal Musiala","GER","MF","Bayern Munich","20.0","36","21","7","16","13","12","29","17","30","0","30","8","5","1"
"Florent Muslija","KVX","FW,MF","Freiburg","1.9","5","4","3","1","1","2","2","0","0","0","0","1","1","0"
"Phillipp Mwene","AUT","DF","Mainz 05","29.0","51","29","23","22","6","19","46","27","27","6","21","24","51","1"
"Joakim Mæhle","DEN","DF","Wolfsburg","24.3","34","15","26","6","2","17","45","28","24","3","21","25","57","2"
"Nathan N'Goumou","CMR","FW","Gladbach","9.2","17","11","11","4","2","6","11","5","8","2","6","4","16","0"
"Stanley N'Soki","FRA","DF","Hoffenheim","14.5","22","16","13","7","2","12","23","11","22","7","15","26","58","3"
"Nikolas Nartey","DEN","MF","Stuttgart","0.2","0","0","0","0","0","0","0","0","0","0","0","0","4","0"
"Paul Nebel","GER","MF","Mainz 05","26.1","38","24","11","18","9","11","35","24","54","4","50","13","30","2"
"Kosta Nedeljković","SRB","DF","RB Leipzig","5.3","11","8","5","6","0","6","10","4","6","4","2","2","14","0"
"Ivan Nekić","CRO","DF","Holstein Kiel","0.8","1","1","1","0","0","1","2","1","1","0","1","3","2","0"
"David Nemeth","AUT","DF","St. Pauli","23.7","43","29","25","16","2","25","43","18","29","11","18","18","94","2"
"Luca Netz","GER","DF","Gladbach","10.8","24","14","14","8","2","13","19","6","17","4","13","10","36","0"
"Manuel Neuer","GER","GK","Bayern Munich","22.0","1","0","1","0","0","1","1","0","0","0","0","0","9","1"
"Florian Neuhaus","GER","MF","Gladbach","4.2","10","3","7","3","0","7","17","10","9","2","7","6","5","1"
"Moritz Nicolas","GER","GK","Gladbach","18.2","0","0","0","0","0","0","0","0","1","0","1","1","8","1"
"Julian Niehues","GER","MF","Heidenheim","1.7","3","1","3","0","0","1","5","4","1","0","1","0","8","0"
"Justin Njinmah","GER","FW,MF","Werder Bremen","10.6","6","2","1","4","1","3","5","2","5","0","5","3","1","0"
"Niels Nkounkou","FRA","DF,MF","Eint Frankfurt","4.2","13","10","7","3","3","4","7","3","5","2","3","7","15","0"
"Felix Nmecha","GER","MF","Dortmund","16.8","34","22","6","19","9","12","22","10","20","5","15","23","30","1"
"Lukas Nmecha","GER","FW,MF","Wolfsburg","5.2","2","0","1","1","0","0","1","1","3","0","3","2","4","0"
"Arnaud Nordin","FRA","DF,MF","Mainz 05","0.9","2","0","0","2","0","1","1","0","2","1","1","0","2","0"
"Alexander Nübel","GER","GK","Stuttgart","34.0","0","0","0","0","0","0","1","1","0","0","0","0","18","3"
"Antonio Nusa","NOR","MF,DF","RB Leipzig","17.3","30","17","16","9","5","18","36","18","22","2","20","8","11","0"
"David Odogu","GER","DF","Wolfsburg","2.2","6","4","4","2","0","3","5","2","2","2","0","2","25","1"
"Tim Oermann","GER","DF","Bochum","24.6","50","31","25","21","4","26","43","17","32","16","16","22","64","0"
"Ifechukwu Ogbus","SUI","DF","Freiburg","0.2","1","1","0","0","1","0","1","1","0","0","0","1","2","0"
"Finn Ole Becker","GER","MF","Hoffenheim","7.4","11","5","4","6","1","1","4","3","7","3","4","10","20","0"
"Michael Olise","FRA","FW,MF","Bayern Munich","25.9","36","23","10","21","5","17","38","21","23","1","22","8","16","2"
"Jonas Omlin","SUI","GK","Gladbach","10.9","0","0","0","0","0","0","1","1","0","0","0","0","5","1"
"Karim Onisiwo","AUT","MF,FW","Mainz 05","1.2","1","1","0","0","1","0","0","0","0","0","0","0","0","0"
"Frank Onyeka","NGA","MF","Augsburg","28.7","58","45","22","28","8","22","40","18","36","9","27","36","36","2"
"Loïs Openda","BEL","FW,MF","RB Leipzig","27.3","9","4","3","4","2","3","11","8","19","1","18","5","12","0"
"Gift Orban","NGA","FW","Hoffenheim","7.6","3","1","2","1","0","1","6","5","7","0","7","0","3","0"
"Willi Orban","HUN","DF","RB Leipzig","24.7","38","21","23","14","1","23","32","9","45","31","14","21","169","4"
"Ivan Ordets","UKR","DF","Bochum","20.7","18","8","13","5","0","10","13","3","29","16","13","41","139","3"
"Patrick Osterhage","GER","MF","Freiburg","25.2","45","29","16","27","2","14","30","16","27","3","24","18","37","0"
"Assan Ouedraogo","GER","MF","RB Leipzig","0.6","0","0","0","0","0","0","0","0","1","0","1","0","0","0"
"Salih Özcan","TUR","MF","Wolfsburg","3.9","2","2","1","0","1","1","5","4","5","1","4","7","5","0"
"Salih Özcan","TUR","MF","Dortmund","4.3","11","7","6","4","1","7","13","6","7","0","7","11","10","0"
"Exequiel Palacios","ARG","MF","Leverkusen","12.8","22","15","8","10","4","10","18","8","14","1","13","13","15","1"
"João Palhinha","POR","MF","Bayern Munich","7.5","20","14","6","11","3","11","16","5","13","1","12","4","9","1"
"Mats Pannewig","GER","MF","Bochum","3.0","10","6","7","3","0","3","12","9","8","1","7","2","8","0"
"Kevin Paredes","USA","DF","Wolfsburg","1.4","3","1","3","0","0","2","3","1","2","2","0","1","0","0"
"Felix Passlack","GER","DF,MF","Bochum","25.9","53","23","32","13","8","30","55","25","42","11","31","18","63","1"
"Aleksandar Pavlovic","GER","MF","Bayern Munich","16.1","38","21","13","15","10","22","32","10","18","3","15","5","14","0"
"Mads Pedersen","DEN","DF","Augsburg","2.6","8","7","5","2","1","4","5","1","4","0","4","2","6","0"
"Jordan Pefok","USA","FW","Union Berlin","10.1","11","6","6","0","5","3","7","4","9","2","7","4","18","0"
"Daniel Peretz","ISR","GK","Bayern Munich","3.0","0","0","0","0","0","0","1","1","0","0","0","0","2","0"
"Noah Pesch","CRO","FW","Gladbach","0.1","1","0","0","0","1","0","0","0","0","0","0","0","0","0"
"Luca Philipp","GER","GK","Hoffenheim","6.0","1","0","1","0","0","1","1","0","0","0","0","0","1","0"
"Maximilian Philipp","GER","MF,FW","Freiburg","0.2","0","0","0","0","0","0","0","0","0","0","0","0","0","0"
"Benedikt Pichler","AUT","FW","Holstein Kiel","8.7","5","2","1","0","4","2","4","2","4","2","2","2","11","0"
"Amos Pieper","GER","DF","Werder Bremen","16.6","32","17","16","11","5","21","33","12","28","17","11","24","98","1"
"Marvin Pieringer","GER","FW,MF","Heidenheim","24.5","23","13","5","12","6","5","10","5","21","2","19","8","32","0"
"Alassane Pléa","FRA","MF,FW","Gladbach","21.1","7","3","0","2","5","4","13","9","11","0","11","2","7","1"
"Finn Porath","GER","DF,MF","Holstein Kiel","21.9","45","26","24","14","7","26","53","27","27","9","18","21","67","0"
"Yussuf Poulsen","DEN","FW,MF","RB Leipzig","4.2","10","5","2","6","2","4","8","4","7","2","5","0","14","0"
"Alexander Prass","AUT","DF","Hoffenheim","17.4","42","23","24","15","3","24","59","35","33","6","27","9","53","4"
"David Preu","GER","MF,DF","Union Berlin","1.3","1","1","0","1","0","0","2","2","4","2","2","0","2","0"
"Grischa Prömel","GER","MF","Hoffenheim","1.9","0","0","0","0","0","0","1","1","1","1","0","2","4","0"
"Ivan Prtajin","CRO","FW","Union Berlin","1.8","3","2","0","1","2","0","0","0","2","0","2","0","3","0"
"Tymoteusz Puchacz","POL","DF","Holstein Kiel","4.4","9","4","6","3","0","5","7","2","4","1","3","3","11","0"
"Leopold Querfeld","AUT","DF","Union Berlin","19.4","25","12","21","4","0","13","18","5","25","10","15","19","144","2"
"Grant Ranos","ARM","FW","Gladbach","0.2","1","0","0","1","0","0","1","1","2","0","2","0","0","0"
"David Raum","GER","DF","RB Leipzig","19.8","38","28","16","14","8","20","35","15","25","8","17","9","47","4"
"Rocco Reitz","GER","MF","Gladbach","20.3","52","24","24","24","4","24","43","19","39","16","23","53","59","2"
"Nicolai Remberg","GER","MF","Holstein Kiel","26.9","45","25","24","17","4","19","41","22","46","20","26","29","100","0"
"Elvis Rexhbeçaj","KVX","MF","Augsburg","19.8","27","19","9","14","4","15","35","20","40","9","31","16","22","1"
"Gio Reyna","USA","MF","Dortmund","3.9","7","0","3","0","4","4","5","1","3","1","2","0","9","0"
"Fabian Rieder","SUI","MF,FW","Stuttgart","9.6","17","14","4","9","4","7","23","16","10","1","9","10","7","1"
"Lasse Rieß","GER","GK","Mainz 05","2.0","0","0","0","0","0","0","0","0","0","0","0","0","5","0"
"Lars Ritzka","GER","DF,MF","St. Pauli","10.2","49","29","28","16","5","25","41","16","16","2","14","11","41","0"
"Mads Roerslev","DEN","DF","Wolfsburg","3.3","10","9","8","1","1","6","9","3","2","2","0","5","16","0"
"Merlin Röhl","GER","MF,FW","Freiburg","10.7","16","10","4","10","2","9","11","2","9","1","8","6","2","0"
"Lasse Rosenboom","GER","DF","Holstein Kiel","19.3","47","35","25","16","6","32","47","15","28","9","19","19","71","3"
"Max Rosenfelder","GER","DF","Freiburg","13.9","27","17","17","10","0","14","19","5","17","9","8","7","65","0"
"Tom Rothe","GER","DF,MF","Union Berlin","18.6","45","28","27","15","3","29","51","22","41","5","36","18","57","1"
"Anthony Rouault","FRA","DF","Stuttgart","13.5","15","11","10","3","2","10","15","5","18","9","9","19","63","1"
"Jérôme Roussillon","FRA","DF,MF","Union Berlin","1.5","0","0","0","0","0","0","2","2","0","0","0","2","7","0"
"Julian Ryerson","NOR","DF","Dortmund","25.1","46","30","26","13","7","25","44","19","29","2","27","22","26","1"
"Frederik Rønnow","DEN","GK","Union Berlin","28.0","0","0","0","0","0","0","1","1","0","0","0","0","22","2"
"Elias Saad","TUN","FW,MF","St. Pauli","10.0","20","13","7","8","5","10","20","10","14","0","14","3","1","0"
"Marcel Sabitzer","AUT","MF","Dortmund","18.0","29","19","7","15","7","16","27","11","19","6","13","10","29","1"
"Faik Sakar","GER","MF","RB Leipzig","0.0","0","0","0","0","0","0","0","0","0","0","0","0","0","0"
"Manolis Saliakas","GRE","MF,DF","St. Pauli","25.7","46","22","24","18","4","25","49","24","38","8","30","20","62","0"
"Roland Sallai","HUN","FW,MF","Freiburg","0.5","2","1","1","1","0","0","0","0","0","0","0","1","0","0"
"Diadie Samassékou","MLI","MF","Hoffenheim","3.2","5","5","1","2","2","2","4","2","4","2","2","5","5","0"
"Philipp Sander","GER","MF","Gladbach","15.6","33","17","16","15","2","10","23","13","16","7","9","23","44","3"
"James Sands","USA","MF,DF","St. Pauli","5.0","15","6","5","8","2","4","4","0","5","1","4","5","8","0"
"Leroy Sané","GER","FW","Bayern Munich","18.2","23","15","4","8","11","12","23","11","8","0","8","7","3","0"
"Kaishu Sano","JPN","MF","Mainz 05","33.8","61","36","22","31","8","25","52","27","66","14","52","65","56","1"
"Kauã Santos","BRA","GK","Eint Frankfurt","8.5","0","0","0","0","0","0","0","0","0","0","0","0","10","2"
"Joe Scally","USA","DF","Gladbach","28.6","45","32","25","18","2","27","46","19","35","11","24","16","86","2"
"András Schäfer","HUN","MF","Union Berlin","17.0","52","26","23","24","5","25","41","16","33","6","27","22","36","0"
"Patrik Schick","CZE","FW","Leverkusen","18.7","6","5","1","3","2","1","5","4","9","1","8","4","17","1"
"Stefan Schimmer","GER","FW,MF","Heidenheim","2.7","2","0","1","1","0","1","2","1","1","0","1","0","4","0"
"Xaver Schlager","AUT","MF","RB Leipzig","2.0","4","2","2","1","1","3","7","4","7","0","7","0","3","0"
"Keven Schlotterbeck","GER","DF","Augsburg","14.4","19","17","9","9","1","12","16","4","13","6","7","15","73","1"
"Nico Schlotterbeck","GER","DF","Dortmund","22.0","38","24","21","16","1","27","45","18","31","15","16","22","79","1"
"Romano Schmid","AUT","MF","Werder Bremen","31.5","43","25","10","22","11","24","51","27","42","3","39","11","9","2"
"Jan Schöppner","GER","MF","Heidenheim","29.8","56","30","19","27","10","20","58","38","38","6","32","43","95","1"
"Marvin Schulz","GER","MF,DF","Holstein Kiel","3.4","6","5","2","2","2","2","8","6","12","8","4","0","17","0"
"Alexander Schwolow","GER","GK","Union Berlin","6.0","0","0","0","0","0","0","0","0","0","0","0","0","2","1"
"Léo Scienza","BRA","FW,MF","Heidenheim","12.8","17","12","10","5","2","7","18","11","13","1","12","5","9","1"
"Nicolas Seiwald","AUT","MF,DF","RB Leipzig","23.2","53","31","19","29","5","25","50","25","43","10","33","31","76","2"
"Benjamin Šeško","SVN","FW,MF","RB Leipzig","26.4","7","3","0","4","3","3","11","8","15","4","11","5","20","0"
"Armindo Sieb","GER","FW,MF","Mainz 05","8.5","10","4","4","5","1","3","10","7","4","0","4","1","7","0"
"Tim Siersleben","GER","DF","Heidenheim","13.1","21","14","12","8","1","7","17","10","19","6","13","20","66","0"
"Kiliann Sildillia","FRA","DF","Freiburg","8.9","17","10","8","6","3","7","13","6","16","5","11","11","38","0"
"André Silva","POR","FW","Werder Bremen","4.2","2","2","1","1","0","0","1","1","3","1","2","0","3","0"
"André Silva","POR","FW,MF","RB Leipzig","1.5","1","1","1","0","0","0","1","1","1","0","1","1","2","0"
"Mohamed Simakan","FRA","DF","RB Leipzig","0.6","0","0","0","0","0","0","0","0","0","0","0","2","0","0"
"Xavi Simons","NED","MF","RB Leipzig","23.9","28","21","5","15","8","12","26","14","19","3","16","12","19","1"
"Danel Sinani","LUX","FW,MF","St. Pauli","13.9","14","11","2","7","5","6","14","8","12","1","11","1","13","0"
"Tobias Sippel","GER","GK","Gladbach","0.7","0","0","0","0","0","0","0","0","0","0","0","0","0","0"
"Ibrahima Sissoko","MLI","MF","Bochum","29.0","66","44","30","31","5","24","45","21","39","11","28","36","61","0"
"Tim Skarke","GER","FW,MF","Union Berlin","12.9","14","11","5","8","1","10","19","9","7","0","7","5","17","0"
"Ellyes Skhiri","TUN","MF","Eint Frankfurt","24.8","40","22","15","21","4","18","44","26","30","7","23","31","45","4"
"Leo Skiri Østigård","NOR","DF","Hoffenheim","10.3","9","7","5","4","0","4","6","2","17","9","8","9","111","0"
"Andreas Skov Olsen","DEN","FW,MF","Wolfsburg","5.9","8","6","5","3","0","4","4","0","4","0","4","2","12","0"
"Robert Skov","DEN","DF,MF","Union Berlin","9.5","15","11","8","7","0","10","20","10","8","1","7","8","9","0"
"Steven Skrzybski","GER","MF,FW","Holstein Kiel","14.7","19","6","7","6","6","7","24","17","16","0","16","11","11","0"
"Eric Smith","SWE","DF,MF","St. Pauli","31.4","46","29","26","17","3","23","40","17","37","10","27","37","104","4"
"Anton Stach","GER","MF,DF","Hoffenheim","28.7","66","46","25","37","4","32","47","15","47","13","34","46","101","2"
"Jens Stage","DEN","MF","Werder Bremen","24.5","49","30","22","24","3","25","46","21","44","10","34","18","42","2"
"Josip Stanišić","CRO","DF","Bayern Munich","9.7","13","11","6","4","3","7","15","8","10","6","4","6","29","1"
"Niklas Stark","GER","DF","Werder Bremen","23.4","33","21","20","11","2","14","21","7","41","27","14","36","129","1"
"Pascal Stenzel","GER","DF","Stuttgart","3.2","3","2","1","0","2","2","5","3","5","1","4","2","6","0"
"Leonidas Stergiou","SUI","DF","Stuttgart","9.5","24","13","9","11","4","16","19","3","16","5","11","14","39","0"
"Finley Stevens","WAL","DF","St. Pauli","0.0","0","0","0","0","0","0","0","0","0","0","0","0","0","0"
"Angelo Stiller","GER","MF","Stuttgart","30.5","49","27","18","25","6","14","30","16","29","9","20","26","50","4"
"Kevin Stöger","AUT","MF","Gladbach","17.2","37","21","23","10","4","16","39","23","24","3","21","16","26","3"
"Niklas Süle","GER","DF","Dortmund","11.7","14","12","9","5","0","10","14","4","11","6","5","4","46","1"
"Mattias Svanberg","SWE","MF","Wolfsburg","13.5","20","10","6","11","3","9","19","10","11","4","7","15","26","0"
"Daniel Svensson","SWE","DF,FW","Dortmund","8.7","15","11","5","6","4","7","11","4","10","4","6","5","30","0"
"Haris Tabakovic","BIH","FW","Hoffenheim","9.1","3","1","1","0","2","0","3","3","4","2","2","1","16","0"
"Jonathan Tah","GER","DF","Leverkusen","33.0","19","12","12","6","1","10","16","6","22","16","6","36","157","2"
"Edmond Tapsoba","BFA","DF","Leverkusen","27.9","39","24","19","16","4","22","39","17","21","14","7","24","89","3"
"Mathys Tel","FRA","FW,MF","Bayern Munich","2.8","2","2","0","2","0","0","0","0","0","0","0","1","1","0"
"Nathan Tella","NGA","MF,FW","Leverkusen","15.1","16","11","4","7","5","5","13","8","15","1","14","4","10","0"
"Martin Terrier","FRA","MF,FW","Leverkusen","6.5","4","2","1","0","3","1","4","3","3","0","3","1","1","0"
"Arthur Theate","BEL","DF","Eint Frankfurt","30.0","36","25","19","16","1","22","44","22","42","19","23","39","170","3"
"Norman Theuerkauf","GER","MF","Heidenheim","0.2","0","0","0","0","0","0","0","0","0","0","0","0","0","0"
"Denis Thomalla","GER","MF","Heidenheim","0.0","0","0","0","0","0","0","0","0","0","0","0","0","0","0"
"Phillip Tietz","GER","FW","Augsburg","18.7","11","6","2","7","2","5","8","3","10","1","9","5","26","1"
"Umut Tohumcu","GER","MF,FW","Hoffenheim","4.2","9","5","3","5","1","5","7","2","5","0","5","3","6","0"
"John Tolkin","USA","DF,MF","Holstein Kiel","8.2","18","11","11","7","0","12","14","2","10","2","8","8","54","0"
"Tiago Tomás","POR","FW,MF","Wolfsburg","20.9","33","19","15","11","7","15","35","20","17","4","13","9","19","0"
"Bazoumana Touré","CIV","FW,MF","Hoffenheim","6.8","12","10","2","7","3","2","8","6","4","0","4","3","2","0"
"Lucas Tousart","FRA","MF","Union Berlin","6.2","17","9","6","9","2","5","12","7","11","4","7","7","27","0"
"Omar Traoré","GER","DF","Heidenheim","29.1","50","26","31","16","3","25","41","16","35","6","29","21","66","0"
"Kevin Trapp","GER","GK","Eint Frankfurt","25.5","0","0","0","0","0","0","0","0","0","0","0","0","13","3"
"Philipp Treu","GER","MF,DF","St. Pauli","32.0","61","42","35","17","9","39","68","29","52","12","40","19","87","2"
"Christopher Trimmel","AUT","DF,MF","Union Berlin","19.3","38","25","23","14","1","28","42","14","14","6","8","18","92","0"
"Tuta","BRA","DF,MF","Eint Frankfurt","25.3","44","27","25","17","2","28","40","12","42","21","21","40","135","1"
"Lukas Ullrich","GER","DF","Gladbach","21.1","25","16","18","6","1","15","42","27","26","9","17","23","74","1"
"Sven Ulreich","GER","GK","Bayern Munich","1.0","0","0","0","0","0","0","0","0","0","0","0","0","0","0"
"Deniz Undav","GER","FW,MF","Stuttgart","19.2","11","10","2","3","6","1","17","16","15","2","13","3","10","0"
"Dayot Upamecano","FRA","DF","Bayern Munich","19.5","36","22","18","16","2","16","29","13","17","7","10","34","45","1"
"Jonas Urbig","GER","GK","Bayern Munich","8.0","0","0","0","0","0","0","0","0","0","0","0","0","9","2"
"Can Uzun","TUR","MF,FW","Eint Frankfurt","7.5","10","4","1","4","5","5","10","5","9","0","9","1","3","0"
"Josha Vagnoman","GER","DF,MF","Stuttgart","20.4","26","14","11","13","2","17","34","17","16","2","14","14","57","1"
"Siebe Van Der Heyden","BEL","DF,MF","St. Pauli","9.7","17","10","10","7","0","8","18","10","8","4","4","17","43","2"
"Maarten Vandevoordt","BEL","GK","RB Leipzig","4.8","1","0","1","0","0","1","1","0","0","0","0","0","4","0"
"Ruben Vargas","SUI","MF,FW","Augsburg","3.4","2","1","1","1","0","1","4","3","1","0","1","2","1","1"
"Nikola Vasilj","BIH","GK","St. Pauli","33.0","0","0","0","0","0","0","2","2","0","0","0","0","22","3"
"Denis Vavro","SVK","DF","Wolfsburg","27.3","21","13","16","5","0","11","23","12","48","32","16","37","234","3"
"Miloš Veljković","SRB","DF","Werder Bremen","11.4","10","5","6","3","1","7","15","8","14","9","5","2","47","1"
"Nikolas Veratschnig","AUT","DF,MF","Mainz 05","4.0","9","6","1","4","4","2","3","1","4","0","4","5","8","0"
"Arthur Vermeeren","BEL","MF","RB Leipzig","17.5","32","19","14","13","5","14","47","33","34","12","22","23","25","2"
"Yorbe Vertessen","BEL","MF,FW","Union Berlin","8.0","6","3","3","2","1","2","8","6","6","0","6","3","6","0"
"Gabriel Vidovic","CRO","MF","Bayern Munich","0.3","0","0","0","0","0","0","0","0","2","0","2","0","0","0"
"Gabriel Vidovic","CRO","MF","Mainz 05","0.0","0","0","0","0","0","0","0","0","0","0","0","0","0","0"
"Kevin Vogt","GER","DF","Union Berlin","15.2","12","8","7","5","0","8","13","5","16","8","8","9","75","1"
"Kevin Volland","GER","FW,MF","Union Berlin","0.7","0","0","0","0","0","0","0","0","1","0","1","0","1","0"
"Aster Vranckx","BEL","MF","Wolfsburg","6.2","11","6","3","8","0","3","9","6","14","3","11","10","13","0"
"Robert Wagner","GER","MF","St. Pauli","4.5","8","3","2","6","0","4","13","9","8","0","8","2","12","0"
"Elye Wahi","FRA","FW,MF","Eint Frankfurt","2.2","0","0","0","0","0","0","1","1","1","0","1","0","1","0"
"Hauke Wahl","GER","DF","St. Pauli","33.0","36","27","21","13","2","23","38","15","44","25","19","31","170","4"
"Paul Wanner","GER","MF,FW","Heidenheim","19.7","40","27","16","21","3","15","32","17","15","0","15","4","20","0"
"Kjell-Arik Wätjen","GER","MF","Dortmund","0.2","0","0","0","0","0","0","0","0","0","0","0","0","2","0"
"Julian Weigl","GER","MF","Gladbach","32.0","53","25","24","24","5","28","46","18","54","27","27","48","86","3"
"Timon Weiner","GER","GK","Holstein Kiel","25.0","0","0","0","0","0","0","1","1","0","0","0","0","17","3"
"Nelson Weiper","GER","FW,MF","Mainz 05","7.8","5","4","2","3","0","2","4","2","5","0","5","2","5","1"
"Mitchell Weiser","GER","DF,MF","Werder Bremen","31.9","61","40","19","34","8","28","56","28","33","3","30","22","61","3"
"Noah Weißhaupt","GER","FW,MF","St. Pauli","12.9","6","4","3","0","3","3","8","5","7","0","7","2","8","1"
"Noah Weißhaupt","GER","FW","Freiburg","0.9","0","0","0","0","0","0","1","1","0","0","0","0","1","0"
"Silvan Widmer","SUI","DF","Mainz 05","5.6","11","5","3","6","2","8","12","4","7","1","6","5","27","0"
"Patrick Wimmer","AUT","MF,FW","Wolfsburg","19.7","47","35","19","21","7","15","46","31","31","4","27","32","15","2"
"Jonas Wind","DEN","FW,MF","Wolfsburg","21.8","10","6","1","8","1","4","8","4","17","3","14","6","15","0"
"Florian Wirtz","GER","MF,FW","Leverkusen","26.1","32","20","10","12","10","9","22","13","32","3","29","10","6","1"
"Dani de Wit","NED","MF,FW","Bochum","12.8","29","17","11","15","3","18","31","13","17","4","13","12","23","1"
"Maximilian Wittek","GER","DF","Bochum","30.1","65","42","40","19","6","38","54","16","54","8","46","27","89","3"
"Marius Wolf","GER","DF","Augsburg","23.8","27","16","13","11","3","16","43","27","29","5","24","24","51","1"
"Nick Woltemade","GER","FW,MF","Stuttgart","18.0","10","7","2","4","4","6","10","4","23","2","21","1","15","1"
"Jeong Woo-yeong","KOR","MF,FW","Union Berlin","14.0","10","7","5","5","0","3","11","8","10","1","9","11","11","0"
"Granit Xhaka","SUI","MF","Leverkusen","32.1","48","26","15","27","6","24","42","18","30","7","23","12","52","6"
"Erencan Yardimci","TUR","FW,MF","Hoffenheim","3.5","4","3","1","3","0","1","2","1","2","0","2","1","2","0"
"Dan-Axel Zagadou","FRA","DF,MF","Stuttgart","0.3","0","0","0","0","0","0","0","0","0","0","0","1","1","0"
"David Zec","SVN","DF","Holstein Kiel","17.1","23","10","17","6","0","13","20","7","32","18","14","17","93","3"
"Robin Zentner","GER","GK","Mainz 05","32.0","2","1","2","0","0","1","2","1","0","0","0","0","31","4"
"Cedric Zesiger","SUI","DF","Augsburg","13.6","13","7","7","6","0","8","13","5","17","10","7","21","96","1"
"Cedric Zesiger","SUI","DF","Wolfsburg","5.8","13","8","6","5","2","6","12","6","6","5","1","3","28","0"
"Michael Zetterer","GER","GK","Werder Bremen","34.0","0","0","0","0","0","0","1","1","1","0","1","1","10","7"
"Budu Zivzivadze","GEO","FW","Heidenheim","10.6","17","11","1","9","7","4","8","4","9","0","9","3","7","0"
"Max Aarons","ENG","DF,MF","Valencia","1.3","4","4","2","2","0","4","5","1","1","0","1","0","3","0"
"Rodrigo Abajas","ESP","DF","Valencia","0.7","3","2","2","1","0","3","3","0","1","0","1","1","0","0"
"Abel","ESP","DF","Osasuna","23.0","61","37","28","25","8","39","63","24","29","4","25","18","64","2"
"Nabil Aberdin","FRA","MF","Getafe","2.9","6","4","3","3","0","1","1","0","3","0","3","0","5","0"
"Abdel Abqar","MAR","DF","Alavés","27.4","36","23","24","11","1","20","34","14","28","18","10","39","146","1"
"Akor Adams","NGA","FW","Sevilla","1.5","0","0","0","0","0","0","0","0","1","0","1","0","1","0"
"Adrián","ESP","GK","Betis","19.0","0","0","0","0","0","0","3","3","0","0","0","0","14","3"
"Julen Agirrezabala","ESP","GK","Athletic Club","13.4","0","0","0","0","0","0","1","1","0","0","0","0","4","0"
"Lucien Agoume","FRA","MF","Sevilla","23.5","70","32","23","37","10","27","39","12","30","11","19","41","42","0"
"Álvaro Aguado","ESP","MF","Espanyol","4.9","5","2","3","2","0","3","9","6","7","1","6","4","5","1"
"Lorenzo Aguado","ESP","DF","Real Madrid","0.1","0","0","0","0","0","0","0","0","0","0","0","0","2","0"
"Nayef Aguerd","MAR","DF","Real Sociedad","19.6","30","24","17","12","1","12","18","6","21","15","6","13","91","0"
"Joseph Aidoo","GHA","DF","Valladolid","6.5","5","5","3","2","0","2","3","1","8","4","4","5","26","1"
"Joseph Aidoo","GHA","DF","Celta Vigo","0.0","1","0","1","0","0","0","0","0","0","0","0","0","0","0"
"Ilias Akhomach","MAR","MF,FW","Villarreal","6.5","12","7","4","4","4","6","12","6","8","0","8","3","13","0"
"David Alaba","AUT","DF","Real Madrid","3.5","1","0","1","0","0","0","0","0","5","5","0","6","7","0"
"Ibrahim Alani","NGA","MF","Valladolid","1.8","12","7","8","4","0","4","6","2","3","1","2","1","1","0"
"Raúl Albiol","ESP","DF","Villarreal","13.2","10","9","9","1","0","6","10","4","10","9","1","6","69","1"
"Omar Alderete","PAR","DF","Getafe","33.0","43","29","30","11","2","20","30","10","38","22","16","40","241","1"
"Carles Aleñá","ESP","MF,FW","Getafe","5.0","6","3","2","3","1","4","13","9","9","1","8","0","7","0"
"Carles Aleñá","ESP","MF,FW","Alavés","12.1","19","12","6","7","6","7","17","10","11","0","11","2","4","0"
"Alfon","ESP","FW,MF","Celta Vigo","15.2","8","3","3","2","3","4","12","8","8","0","8","5","5","1"
"Tadeo Allende","ARG","FW","Celta Vigo","0.0","0","0","0","0","0","0","0","0","0","0","0","0","0","0"
"Domingos André Ribeiro Almeida","POR","MF,FW","Valencia","22.0","48","32","18","21","9","14","39","25","21","3","18","8","14","1"
"Iker Almena","ESP","FW,DF","Girona","0.5","0","0","0","0","0","0","1","1","1","0","1","0","2","0"
"Marcos Alonso","ESP","DF","Celta Vigo","29.4","35","21","19","13","3","25","44","19","22","7","15","34","126","4"
"Adrià Altimira","ESP","DF,FW","Leganés","18.1","41","24","26","12","3","24","40","16","15","6","9","15","54","2"
"Sergi Altimira","ESP","MF","Betis","21.9","61","37","17","38","6","36","60","24","28","1","27","24","43","3"
"Hugo Álvarez","ESP","MF,DF","Celta Vigo","17.5","26","9","12","10","4","10","19","9","19","2","17","8","29","1"
"Julián Álvarez","ARG","FW","Atlético Madrid","27.9","25","17","5","11","9","8","30","22","14","0","14","2","12","1"
"Yeray Álvarez","ESP","DF","Athletic Club","19.8","25","13","14","9","2","15","22","7","10","6","4","34","129","1"
"Selim Amallah","MAR","MF","Valladolid","15.3","30","18","10","18","2","10","18","8","24","2","22","14","5","1"
"Amath","SEN","FW,DF","Valladolid","4.2","2","0","2","0","0","1","8","7","7","1","6","2","6","0"
"Marcos André","BRA","FW","Valladolid","13.2","10","6","3","5","2","5","13","8","18","2","16","3","10","0"
"Leandro Antonetti","PUR","FW","Sevilla","0.3","0","0","0","0","0","0","0","0","0","0","0","0","0","0"
"Antoniu","ESP","FW,MF","Espanyol","11.4","21","10","9","8","4","9","21","12","14","2","12","8","11","1"
"Antony","BRA","FW","Betis","15.1","25","11","6","9","10","8","22","14","12","1","11","10","9","1"
"Anuar","MAR","MF,FW","Valladolid","19.1","38","27","21","12","5","15","28","13","24","8","16","18","26","1"
"Aritz Arambarri","ESP","DF","Leganés","2.0","1","1","1","0","0","1","1","0","2","2","0","3","8","0"
"Mauro Arambarri","URU","MF","Getafe","29.6","48","29","10","33","5","22","48","26","35","6","29","15","46","0"
"Jon Aramburu","VEN","DF","Real Sociedad","27.3","102","70","61","30","11","66","100","34","40","8","32","30","98","0"
"Ronald Araújo","URU","DF","Barcelona","8.4","12","9","6","5","1","4","5","1","6","4","2","9","25","0"
"Adu Ares","ESP","FW","Athletic Club","0.2","0","0","0","0","0","0","1","1","0","0","0","0","0","0"
"Jesús Areso","ESP","DF","Osasuna","34.2","53","38","31","14","8","39","56","17","26","4","22","8","92","0"
"David Argüelles","ESP","MF","Getafe","0.1","0","0","0","0","0","0","0","0","2","0","2","0","0","0"
"José Arnaiz","ESP","FW,MF","Osasuna","1.5","7","5","3","3","1","4","7","3","2","0","2","5","1","0"
"Sergio Arribas","ESP","DF","Betis","1.0","7","4","4","3","0","6","7","1","2","2","0","3","4","0"
"Takuma Asano","JPN","FW,MF","Mallorca","11.7","13","9","5","7","1","6","11","5","7","0","7","6","9","0"
"Raúl Asencio","ESP","DF","Real Madrid","18.6","22","16","18","4","0","10","13","3","11","6","5","16","88","2"
"Iago Aspas","ESP","FW,MF","Celta Vigo","19.4","13","8","4","5","4","8","20","12","18","1","17","8","5","0"
"Yaser Asprilla","COL","FW,MF","Girona","15.6","22","12","6","8","8","8","23","15","14","0","14","7","7","1"
"Ezequiel Ávila","ARG","FW","Betis","7.5","8","3","2","2","4","4","10","6","4","0","4","2","8","0"
"Adam Aznou","MAR","DF","Valladolid","9.7","28","21","20","8","0","21","43","22","24","8","16","10","30","0"
"César Azpilicueta","ESP","DF","Atlético Madrid","9.7","25","14","12","9","4","17","23","6","10","2","8","5","32","0"
"Papa Ba","ESP","MF","Girona","0.5","1","1","1","0","0","0","0","0","1","0","1","0","1","0"
"Loïc Bade","FRA","DF","Sevilla","29.8","47","27","37","10","0","23","31","8","22","13","9","29","162","2"
"Alex Baena","ESP","MF,FW","Villarreal","28.8","28","15","6","14","8","10","39","29","29","2","27","22","22","2"
"Juma Bah","SLE","DF","Valladolid","9.6","10","7","7","3","0","3","5","2","15","8","7","12","60","0"
"Eric Bailly","CIV","DF","Villarreal","6.9","12","4","6","6","0","3","4","1","12","6","6","6","29","0"
"Stefan Bajcetic","ESP","MF,DF","Las Palmas","10.8","29","14","13","13","3","12","28","16","25","4","21","15","26","1"
"Cédric Bakambu","COD","FW","Betis","7.9","6","4","0","5","1","3","7","4","13","2","11","0","5","0"
"Alejandro Balde","ESP","DF","Barcelona","25.4","18","10","10","5","3","11","17","6","24","5","19","5","27","0"
"Iván Balliu","ALB","DF","Rayo Vallecano","13.3","17","14","8","5","4","6","18","12","16","4","12","13","39","0"
"Jonathan Bamba","CIV","FW,MF","Celta Vigo","9.0","12","7","4","6","2","5","12","7","6","0","6","5","6","0"
"Adrian Baquerin","ESP","FW","Valladolid","0.5","1","1","0","1","0","0","0","0","0","0","0","0","1","0"
"Valentín Barco","ARG","DF,FW","Sevilla","3.2","15","9","8","3","4","12","15","3","0","0","0","2","5","0"
"Borna Barišić","CRO","DF","Leganés","0.1","0","0","0","0","0","0","0","0","0","0","0","0","0","0"
"Kike Barja","ESP","FW,MF","Osasuna","3.5","5","4","1","3","1","2","4","2","5","0","5","3","4","0"
"Enzo Barrenechea","ARG","MF","Valencia","24.3","57","30","22","29","6","32","46","14","30","8","22","28","48","1"
"Ander Barrenetxea","ESP","MF,FW","Real Sociedad","14.0","26","19","7","14","5","6","23","17","15","0","15","11","16","1"
"Pablo Barrios","ESP","MF","Atlético Madrid","25.9","46","26","23","20","3","23","47","24","18","5","13","34","33","9"
"Thierno Barry","FRA","FW","Villarreal","25.8","11","8","2","5","4","4","10","6","15","2","13","0","19","0"
"Marc Bartra","ESP","DF","Betis","23.3","33","19","20","13","0","15","26","11","41","25","16","33","148","0"
"Aboubacar Bassinga","CIV","MF","Las Palmas","0.0","0","0","0","0","0","0","0","0","0","0","0","0","0","0"
"Augusto Batalla","ARG","GK","Rayo Vallecano","32.0","4","2","4","0","0","4","6","2","0","0","0","0","15","4"
"Rafael Bauza","ESP","MF","Espanyol","2.0","5","3","3","1","1","4","7","3","3","1","2","0","5","0"
"Sheraldo Becker","SUR","FW,MF","Real Sociedad","11.1","3","2","0","3","0","0","2","2","4","0","4","1","10","0"
"Donny van de Beek","NED","MF","Girona","15.8","29","18","17","7","5","13","26","13","19","3","16","10","12","0"
"Luken Beitia","ESP","DF","Real Sociedad","0.1","1","1","1","0","0","1","1","0","0","0","0","0","2","0"
"Ismael Bekhoucha","MAR","MF,DF","Getafe","0.8","1","1","1","0","0","1","2","1","2","1","1","2","2","0"
"Héctor Bellerín","ESP","DF","Betis","6.4","13","7","7","4","2","10","17","7","5","3","2","6","21","0"
"Jude Bellingham","ENG","MF","Real Madrid","27.6","61","33","20","27","14","28","42","14","37","2","35","28","23","1"
"Fran Beltrán","ESP","MF","Celta Vigo","26.9","50","35","24","21","5","24","56","32","26","6","20","26","34","4"
"Carlos Benavídez","URU","MF","Alavés","5.4","19","14","10","6","3","6","11","5","5","2","3","8","14","1"
"Iker Benito","ESP","FW,MF","Osasuna","0.4","0","0","0","0","0","0","1","1","0","0","0","1","2","0"
"Yuri Berchiche","ESP","DF","Athletic Club","22.7","33","21","19","11","3","19","33","14","25","5","20","27","72","3"
"Álex Berenguer","ESP","FW,MF","Athletic Club","26.0","32","16","6","16","10","14","31","17","23","2","21","10","18","0"
"Marc Bernal","ESP","MF","Barcelona","2.7","8","6","2","5","1","7","8","1","5","1","4","1","4","0"
"Juan Bernat","ESP","DF,MF","Villarreal","2.4","9","7","7","1","1","4","5","1","3","1","2","1","4","0"
"Juan Bernat","ESP","MF,DF","Getafe","7.8","19","13","9","5","5","7","12","5","9","3","6","2","12","0"
"Juan Berrocal","ESP","DF","Getafe","11.8","14","7","10","4","0","10","14","4","6","3","3","15","59","0"
"Antonio Blanco","ESP","MF","Alavés","30.3","67","40","23","37","7","32","83","51","30","7","23","42","48","1"
"Daley Blind","NED","DF","Girona","30.9","49","27","26","19","4","31","48","17","32","9","23","32","94","2"
"Adama Boiro","ESP","DF,FW","Athletic Club","12.2","20","11","11","7","2","10","15","5","10","3","7","12","27","1"
"Enzo Boyomo","CMR","DF","Osasuna","33.2","68","43","46","18","4","30","39","9","34","19","15","44","137","3"
"Enzo Boyomo","CMR","DF","Valladolid","3.0","6","2","4","2","0","3","3","0","4","3","1","1","7","0"
"Darko Brašanac","SRB","MF","Leganés","18.0","26","11","5","15","6","9","17","8","24","11","13","16","34","0"
"Tajon Buchanan","CAN","MF","Villarreal","4.6","10","5","6","4","0","6","9","3","6","0","6","1","1","0"
"Ante Budimir","CRO","FW","Osasuna","32.8","20","9","3","11","6","3","13","10","19","4","15","2","26","0"
"Manu Bueno","ESP","MF,FW","Sevilla","1.6","4","3","0","1","3","1","2","1","0","0","0","0","2","0"
"Endika Buján","ESP","FW","Athletic Club","0.1","0","0","0","0","0","0","1","1","0","0","0","0","0","0"
"Pau Cabanes","ESP","MF,FW","Villarreal","1.8","4","4","0","3","1","3","4","1","5","0","5","3","2","1"
"Pau Cabanes","ESP","MF,FW","Alavés","2.1","8","2","4","3","1","6","13","7","2","0","2","0","1","0"
"Leandro Cabrera","URU","DF","Espanyol","31.9","40","23","29","8","3","19","33","14","35","25","10","30","199","2"
"Fernando Calero","ESP","DF,MF","Espanyol","7.9","18","10","13","4","1","8","12","4","16","9","7","16","50","1"
"Eduardo Camavinga","FRA","MF,DF","Real Madrid","12.2","42","26","23","16","3","19","33","14","24","8","16","18","23","0"
"Sergio Camello","ESP","FW","Rayo Vallecano","12.6","9","3","2","5","2","4","6","2","8","1","7","4","16","0"
"José Campaña","ESP","MF","Las Palmas","13.2","21","16","8","11","2","11","20","9","9","1","8","19","19","2"
"Peio Canales","ESP","MF,FW","Athletic Club","2.9","3","2","0","1","2","1","1","0","3","0","3","2","2","0"
"Antonio Candela","ITA","DF","Valladolid","10.1","9","6","6","2","1","4","11","7","11","6","5","6","33","0"
"Sergi Canós","ESP","MF,FW","Valencia","4.1","11","7","3","4","4","4","10","6","6","1","5","5","5","0"
"Dani Cárdenas","ESP","GK","Rayo Vallecano","6.0","0","0","0","0","0","0","0","0","0","0","0","0","3","0"
"Irvin Cardona","FRA","FW,MF","Espanyol","6.7","8","5","2","4","2","6","16","10","5","1","4","4","10","0"
"Marc Cardona","ESP","FW,DF","Las Palmas","1.5","4","2","1","3","0","0","1","1","0","0","0","0","0","0"
"Sergi Cardona","ESP","DF","Villarreal","32.7","71","48","44","20","7","49","79","30","52","7","45","40","122","1"
"Johnny Cardoso","USA","MF","Betis","23.8","55","31","12","35","8","20","52","32","27","12","15","48","64","1"
"José Carlos González","ESP","DF","Las Palmas","0.1","0","0","0","0","0","0","0","0","0","0","0","0","0","0"
"Carmona","ESP","DF","Sevilla","32.7","83","59","53","21","9","41","77","36","37","11","26","68","92","3"
"Sergio Carreira","ESP","MF,DF","Celta Vigo","18.4","28","16","16","6","6","14","26","12","20","2","18","17","37","0"
"Dani Carvajal","ESP","DF","Real Madrid","6.8","12","8","7","3","2","9","12","3","8","3","5","10","19","1"
"William Carvalho","POR","MF","Betis","5.4","9","6","3","6","0","4","6","2","6","2","4","3","6","0"
"Marc Casado","ESP","MF","Barcelona","17.9","44","25","7","30","7","20","41","21","20","5","15","22","22","1"
"Catena","ESP","DF","Osasuna","34.2","46","28","34","10","2","27","44","17","40","25","15","35","221","2"
"Maximiliano Caufriez","BEL","DF","Valencia","1.0","1","1","1","0","0","1","1","0","2","1","1","1","4","0"
"Dani Ceballos","ESP","MF","Real Madrid","13.5","41","21","17","18","6","20","40","20","16","4","12","14","10","2"
"Franco Cervi","ARG","FW,MF","Celta Vigo","3.0","8","3","2","6","0","3","8","5","4","0","4","8","7","0"
"Raúl Chasco","ESP","DF","Valladolid","1.4","4","1","3","1","0","2","4","2","1","0","1","2","2","0"
"Pep Chavarría","ESP","DF,FW","Rayo Vallecano","28.7","46","36","30","14","2","28","45","17","35","9","26","30","108","1"
"Walid Cheddira","MAR","FW","Espanyol","7.1","5","0","1","1","3","0","1","1","4","0","4","1","6","0"
"Chema","ESP","MF","Real Madrid","0.1","0","0","0","0","0","0","0","0","0","0","0","0","1","0"
"Julián Chicco","ARG","MF,DF","Leganés","3.4","11","7","3","6","2","5","8","3","2","0","2","4","10","0"
"Chiquinho","POR","MF,FW","Mallorca","1.6","1","0","0","1","0","0","7","7","3","0","3","2","0","0"
"Andreas Christensen","DEN","DF","Barcelona","2.8","6","4","4","1","1","4","4","0","2","0","2","4","9","0"
"Jasper Cillessen","NED","GK","Las Palmas","25.9","1","0","1","0","0","1","4","3","0","0","0","0","11","2"
"Pathé Ciss","SEN","MF,DF","Rayo Vallecano","23.8","49","24","26","22","1","20","41","21","31","10","21","40","61","3"
"Seydouba Cissé","GUI","MF","Leganés","27.1","59","37","18","27","14","23","50","27","25","1","24","12","45","1"
"Silvi Clúa","ESP","MF","Girona","1.8","8","7","4","3","1","4","6","2","1","0","1","2","6","0"
"Eray Cömert","SUI","DF,MF","Valladolid","19.8","24","14","15","9","0","12","21","9","28","15","13","24","75","2"
"Santi Comesaña","ESP","MF","Villarreal","28.4","85","49","44","32","9","42","76","34","56","22","34","19","56","1"
"Diego Conde","ESP","GK","Villarreal","21.8","2","2","2","0","0","2","4","2","0","0","0","1","9","2"
"Tomás Conechny","ARG","FW,MF","Alavés","9.4","15","12","6","7","2","9","27","18","14","2","12","6","10","0"
"Copete","ESP","DF","Mallorca","17.0","29","17","18","10","1","11","12","1","24","16","8","17","123","2"
"Iker Córdoba","ESP","DF","Valencia","0.2","0","0","0","0","0","0","0","0","0","0","0","0","1","0"
"Ángel Correa","ARG","FW,MF","Atlético Madrid","8.9","9","3","4","1","4","5","15","10","10","0","10","4","8","0"
"Thierry Correia","POR","DF","Valencia","8.5","27","18","19","5","3","13","23","10","10","1","9","4","18","0"
"Coba da Costa","ESP","MF,FW","Getafe","11.2","29","13","9","16","4","13","26","13","24","0","24","8","10","0"
"Logan Costa","CPV","DF","Villarreal","28.7","38","21","25","12","1","24","29","5","25","14","11","21","115","2"
"Samu Costa","POR","MF","Mallorca","29.4","90","44","45","42","3","35","79","44","48","15","33","32","85","1"
"Thibaut Courtois","BEL","GK","Real Madrid","30.0","0","0","0","0","0","0","0","0","0","0","0","1","15","1"
"Juan Cruz Armada","ESP","DF","Osasuna","16.6","26","14","11","13","2","15","24","9","15","4","11","9","68","0"
"Juan Cruz","ESP","FW,MF","Leganés","25.1","32","19","14","16","2","17","35","18","18","2","16","13","31","0"
"Pau Cubarsí","ESP","DF","Barcelona","29.1","34","23","21","10","3","19","30","11","12","9","3","16","86","1"
"Cucho","COL","FW","Betis","12.7","15","10","2","5","8","6","11","5","13","1","12","7","4","0"
"Arnaut Danjuma","NED","FW","Villarreal","2.2","2","1","0","1","1","0","1","1","1","0","1","0","0","0"
"Arnaut Danjuma","NED","FW,MF","Girona","14.8","8","6","3","3","2","2","7","5","5","1","4","2","4","0"
"Sergi Darder","ESP","MF,FW","Mallorca","30.5","40","26","15","16","9","17","46","29","19","1","18","16","23","1"
"Rodrigo De Paul","ARG","MF","Atlético Madrid","23.4","33","26","12","16","5","14","33","19","25","2","23","6","15","3"
"Mouctar Diakhaby","GUI","DF","Valencia","7.3","8","3","8","0","0","4","6","2","8","6","2","11","56","0"
"Assane Diao","SEN","FW","Betis","3.1","5","3","1","3","1","4","9","5","3","0","3","0","3","0"
"Moussa Diarra","MLI","DF","Alavés","20.7","40","24","19","18","3","17","29","12","15","5","10","21","46","1"
"Brahim Díaz","MAR","FW,MF","Real Madrid","15.4","25","19","9","13","3","7","19","12","16","1","15","4","2","1"
"Daniel Díaz","ESP","MF","Real Sociedad","0.1","1","1","1","0","0","0","0","0","1","0","1","0","0","0"
"Pedro Díaz","ESP","MF","Rayo Vallecano","13.5","23","15","7","14","2","14","41","27","16","0","16","7","7","1"
"Diego","ESP","FW","Leganés","13.3","1","1","0","0","1","1","7","6","4","1","3","2","11","0"
"Stole Dimitrievski","MKD","GK","Valencia","4.0","0","0","0","0","0","0","0","0","0","0","0","0","3","1"
"Yan Diomandé","CIV","MF,FW","Leganés","6.1","14","9","1","8","5","5","15","10","8","0","8","8","6","0"
"Álvaro djaló","ESP","FW","Athletic Club","7.3","8","5","3","2","3","1","3","2","4","0","4","1","4","0"
"Djené","TOG","DF,MF","Getafe","28.3","25","13","12","11","2","12","32","20","18","8","10","21","107","3"
"Marko Dmitrović","SRB","GK","Leganés","32.0","1","1","1","0","0","1","2","1","0","0","0","0","27","3"
"Marc Domenech","ESP","FW,MF","Mallorca","3.4","4","4","2","1","1","2","5","3","2","0","2","0","2","0"
"Carlos Dominguez","ESP","DF","Celta Vigo","13.1","23","11","14","9","0","15","21","6","16","11","5","13","80","1"
"Israel Domínguez","ESP","FW","Sevilla","0.2","0","0","0","0","0","0","0","0","0","0","0","0","0","0"
"Sergi Dominguez","ESP","DF","Barcelona","1.9","1","1","1","0","0","0","0","0","0","0","0","3","7","0"
"Anastasios Douvikas","GRE","FW","Celta Vigo","7.8","9","4","2","6","1","3","6","3","5","2","3","3","6","0"
"Domingos Duarte","POR","DF","Getafe","20.7","28","15","22","4","2","17","21","4","28","16","12","18","152","1"
"Duk","CPV","MF,FW","Leganés","2.0","8","4","3","3","2","3","5","2","4","0","4","1","2","0"
"Pablo Durán","ESP","FW,MF","Celta Vigo","15.5","17","9","4","7","6","5","16","11","12","3","9","8","18","0"
"Hugo Duro","ESP","FW","Valencia","24.1","13","8","4","7","2","5","13","8","11","2","9","10","11","0"
"Chidera Ejuke","NGA","FW","Sevilla","10.7","19","13","8","9","2","9","20","11","12","0","12","5","8","0"
"Aritz Elustondo","ESP","DF","Real Sociedad","16.2","20","11","15","3","2","11","19","8","17","12","5","11","96","0"
"Adri Embarba","ESP","FW,MF","Rayo Vallecano","17.9","41","20","17","17","7","18","47","29","18","1","17","13","14","2"
"Endrick","BRA","FW","Real Madrid","4.0","1","1","1","0","0","1","3","2","0","0","0","4","1","0"
"Alfonso Espino","URU","DF","Rayo Vallecano","9.3","41","24","31","8","2","26","47","21","19","6","13","12","32","1"
"Dario Essugo","POR","MF","Las Palmas","21.5","59","45","28","26","5","28","46","18","28","11","17","42","47","7"
"Etienne Eto'o","CMR","FW","Rayo Vallecano","0.4","0","0","0","0","0","0","1","1","0","0","0","0","1","0"
"Karl Etta","CMR","MF,FW","Villarreal","0.4","0","0","0","0","0","0","1","1","1","0","1","0","0","0"
"Edu Expósito","ESP","MF","Espanyol","11.6","23","13","9","13","1","9","23","14","3","0","3","15","21","2"
"Abde Ezzalzouli","MAR","FW,MF","Betis","22.0","37","25","17","16","4","15","27","12","22","3","19","7","19","0"
"Ansu Fati","ESP","FW","Barcelona","2.6","4","1","0","2","2","1","2","1","1","0","1","1","0","1"
"Nabil Fekir","FRA","MF","Betis","2.0","3","2","1","1","1","1","2","1","2","0","2","0","0","0"
"Kiko Femenía","ESP","DF","Villarreal","24.7","50","34","34","14","2","33","57","24","21","10","11","40","62","3"
"Aitor Fernández","ESP","GK","Osasuna","1.0","0","0","0","0","0","0","0","0","0","0","0","0","2","0"
"Álvaro Fernández","ESP","GK","Sevilla","8.3","0","0","0","0","0","0","1","1","0","0","0","0","7","0"
"Pelayo Fernandez","ESP","DF","Rayo Vallecano","1.1","0","0","0","0","0","0","0","0","0","0","0","2","9","0"
"Roberto Férnandez","ESP","FW","Espanyol","16.6","4","4","2","1","1","0","5","5","9","1","8","3","26","0"
"Valery Fernández","ESP","MF,FW","Mallorca","3.4","8","7","3","2","3","5","7","2","3","1","2","0","1","0"
"André Ferreira","POR","GK","Valladolid","6.0","0","0","0","0","0","0","0","0","0","0","0","0","4","2"
"Mateo Flores","ESP","MF","Betis","1.7","3","1","3","0","0","1","1","0","1","0","1","2","3","0"
"Pablo Fornals","ESP","MF,FW","Betis","20.3","21","13","12","6","3","10","30","20","24","4","20","23","15","1"
"Héctor Fort","ESP","DF","Barcelona","6.5","13","8","6","4","3","10","16","6","12","0","12","6","16","0"
"Dimitri Foulquier","FRA","DF","Valencia","25.5","48","31","29","13","6","24","36","12","21","5","16","16","86","1"
"Juan Foyth","ARG","DF","Villarreal","16.9","25","15","15","6","4","11","16","5","26","17","9","19","119","3"
"Fran","ESP","GK","Real Madrid","1.0","0","0","0","0","0","0","0","0","0","0","0","0","2","0"
"Alejandro Francés","ESP","DF","Girona","13.0","36","24","22","13","1","28","40","12","17","8","9","17","52","0"
"Enric Franquesa","ESP","DF,FW","Leganés","6.8","17","9","9","6","2","9","13","4","7","1","6","5","12","0"
"Jorge de Frutos","ESP","FW,MF","Rayo Vallecano","27.7","37","21","16","13","8","14","46","32","22","0","22","19","24","1"
"Darío Fuentes","ESP","DF","Sevilla","0.1","0","0","0","0","0","0","0","0","0","0","0","0","0","0"
"Manuel Fuster","ESP","FW,MF","Las Palmas","11.1","19","11","5","8","6","15","28","13","13","3","10","4","17","0"
"Javi Galán","ESP","DF","Atlético Madrid","19.8","51","31","31","15","5","25","49","24","13","3","10","12","47","0"
"Iñigo Ruiz de Galarreta","ESP","MF","Athletic Club","16.4","36","22","11","17","8","20","31","11","11","4","7","16","14","2"
"Conor Gallagher","ENG","MF","Atlético Madrid","18.1","45","32","16","19","10","22","49","27","23","5","18","20","23","0"
"Facundo Garcés","MAS","DF","Alavés","7.5","6","2","4","2","0","3","5","2","8","6","2","5","51","0"
"Álvaro García","ESP","FW,MF","Rayo Vallecano","28.4","33","24","19","8","6","12","31","19","31","0","31","32","42","1"
"Eric García","ESP","DF,MF","Barcelona","17.4","38","21","11","24","3","20","29","9","24","8","16","14","41","0"
"Fran Garcia","ESP","DF","Real Madrid","24.1","51","36","29","16","6","28","51","23","27","5","22","28","67","1"
"Gonzalo García","ESP","FW,DF","Real Madrid","0.6","0","0","0","0","0","0","0","0","1","0","1","0","0","0"
"Joan García","ESP","GK","Espanyol","38.0","0","0","0","0","0","0","1","1","1","0","1","0","18","4"
"Pablo Garcia","ESP","FW","Betis","0.4","0","0","0","0","0","0","0","0","1","0","1","0","0","0"
"Rubén García","ESP","FW,MF","Osasuna","26.8","52","31","20","21","11","26","60","34","37","3","34","15","34","1"
"Unai García","ESP","DF","Osasuna","0.7","0","0","0","0","0","0","0","0","1","0","1","0","1","0"
"Yarek Gasiorowski","ESP","DF","Valencia","10.5","19","16","16","3","0","9","13","4","17","6","11","26","60","0"
"Gavi","ESP","MF,FW","Barcelona","12.1","30","21","10","15","5","15","26","11","14","1","13","10","7","0"
"Paulo Gazzaniga","ARG","GK","Girona","35.5","1","1","1","0","0","1","1","0","1","0","1","0","17","3"
"Bryan Gil","ESP","FW,MF","Girona","19.1","34","20","10","15","9","14","30","16","24","0","24","10","9","4"
"Dani Gómez","ESP","FW","Valencia","5.9","3","2","0","0","3","0","0","0","1","0","1","2","4","0"
"Moi Gómez","ESP","MF,FW","Osasuna","8.8","13","9","4","7","2","4","8","4","5","2","3","6","7","1"
"Sergi Gómez","ESP","DF","Espanyol","7.4","8","5","7","1","0","2","3","1","12","8","4","7","38","0"
"Sergio Gómez","ESP","MF,DF","Real Sociedad","30.4","71","39","30","29","12","30","56","26","44","3","41","19","30","2"
"Unai Gómez","ESP","MF,FW","Athletic Club","14.3","12","8","3","7","2","4","7","3","13","1","12","2","15","1"
"Fabio González","ESP","MF","Las Palmas","0.6","0","0","0","0","0","0","1","1","0","0","0","0","0","0"
"Peter González","DOM","MF,FW","Getafe","5.3","11","6","2","5","4","6","9","3","8","0","8","2","5","0"
"Urko González","ESP","MF","Espanyol","15.3","46","28","24","21","1","28","44","16","27","12","15","8","39","1"
"Urko González","ESP","MF","Real Sociedad","0.5","0","0","0","0","0","0","0","0","1","1","0","0","0","0"
"Andoni Gorosabel","ESP","DF","Athletic Club","16.5","47","28","31","9","7","30","45","15","18","2","16","18","62","0"
"José Gragera","ESP","MF","Espanyol","6.3","25","16","11","14","0","9","17","8","9","1","8","5","13","0"
"Dominik Greif","SVK","GK","Mallorca","31.0","0","0","0","0","0","0","0","0","0","0","0","0","13","1"
"Antoine Griezmann","FRA","FW,MF","Atlético Madrid","27.4","30","17","13","13","4","7","29","22","20","1","19","6","23","1"
"Florian Grillitsch","AUT","MF","Valladolid","6.9","11","7","7","3","1","7","15","8","12","2","10","4","5","1"
"Vicente Guaita","ESP","GK","Celta Vigo","34.0","0","0","0","0","0","0","0","0","0","0","0","0","21","3"
"Sergi Guardiola","ESP","FW","Rayo Vallecano","4.0","5","3","0","5","0","2","3","1","1","0","1","1","2","0"
"Nemanja Gudelj","SRB","MF,DF","Sevilla","27.7","42","24","16","22","4","21","35","14","27","10","17","27","94","1"
"Javier Guerra","ESP","MF","Valencia","28.7","50","27","18","21","11","26","56","30","15","3","12","20","49","3"
"Ander Guevara","ESP","MF","Alavés","21.6","49","30","19","29","1","20","48","28","21","5","16","14","43","1"
"Pape Gueye","SEN","MF","Villarreal","24.7","54","26","23","23","8","20","29","9","31","13","18","27","53","2"
"Hugo Guillamón","ESP","MF","Valencia","4.0","11","8","1","9","1","9","10","1","4","1","3","5","9","1"
"Carlos Guirao","ESP","MF","Betis","1.2","5","3","1","4","0","4","6","2","1","1","0","3","2","0"
"Arda Güler","TUR","MF,FW","Real Madrid","13.9","30","16","11","8","11","9","22","13","18","0","18","7","8","0"
"Gerard Gumbau","ESP","MF","Rayo Vallecano","9.4","17","12","8","7","2","7","15","8","13","4","9","5","13","0"
"Jon Guridi","ESP","MF,FW","Alavés","23.1","40","22","7","26","7","18","44","26","19","1","18","14","16","0"
"Gorka Guruzeta","ESP","FW","Athletic Club","20.4","16","8","1","13","2","7","31","24","28","4","24","9","23","0"
"Miguel Gutiérrez","ESP","DF,MF","Girona","27.3","37","24","18","16","3","17","37","20","17","7","10","16","34","3"
"Munir El Haddadi","MAR","FW,MF","Leganés","9.6","12","9","5","4","3","3","12","9","8","1","7","1","1","1"
"Sébastien Haller","CIV","FW","Leganés","4.5","2","0","1","0","1","1","2","1","1","0","1","0","7","0"
"Henrique","BRA","DF","Valladolid","3.9","6","2","3","2","1","1","4","3","5","0","5","3","12","0"
"Javi Hernández","ESP","DF","Leganés","26.5","26","15","16","7","3","17","46","29","25","5","20","23","98","0"
"Aridane Hernández","ESP","DF","Rayo Vallecano","11.4","13","11","9","4","0","6","8","2","10","8","2","6","99","2"
"Jorge Herrando","ESP","DF","Osasuna","15.2","17","11","9","5","3","9","15","6","20","14","6","12","65","2"
"Ander Herrera","ESP","MF","Athletic Club","3.0","8","4","1","7","0","3","6","3","1","0","1","2","10","0"
"Sergio Herrera","ESP","GK","Osasuna","37.0","2","1","2","0","0","2","6","4","1","0","1","0","29","1"
"Yangel Herrera","VEN","MF","Girona","25.1","66","39","31","27","8","30","59","29","24","8","16","31","50","2"
"Juan Herzog","ESP","DF","Las Palmas","14.6","12","12","12","0","0","9","16","7","17","11","6","18","86","0"
"Omar El Hilali","MAR","DF","Espanyol","35.0","111","79","81","24","6","64","95","31","53","13","40","46","145","2"
"Roger Hinojo","ESP","DF","Espanyol","0.1","0","0","0","0","0","0","0","0","0","0","0","0","1","0"
"Dinko Horkaš","CRO","GK","Las Palmas","12.1","0","0","0","0","0","0","0","0","0","0","0","0","9","1"
"Pablo Ibáñez","ESP","MF","Osasuna","14.4","20","10","7","12","1","10","40","30","20","7","13","18","21","0"
"Stanis Idumbo","BEL","FW,MF","Sevilla","3.2","9","5","3","4","2","3","5","2","3","1","2","4","2","0"
"Iglesias","ESP","DF","Getafe","32.1","81","47","42","33","6","46","90","44","47","8","39","50","133","1"
"Borja Iglesias","ESP","FW","Celta Vigo","21.7","10","9","2","5","3","4","15","11","9","2","7","7","10","0"
"Kelechi Iheanacho","NGA","FW","Sevilla","4.4","1","0","0","1","0","1","3","2","0","0","0","0","1","0"
"Isco","ESP","MF","Betis","17.2","20","13","3","13","4","7","28","21","10","0","10","11","7","0"
"Diego Iturralde","ESP","FW","Sevilla","0.4","0","0","0","0","0","0","0","0","0","0","0","1","1","0"
"Ivan Jaime Pajuelo","ESP","MF","Valencia","3.3","8","5","2","3","3","4","5","1","2","0","2","2","0","0"
"Karl Jakob Hein","EST","GK","Valladolid","31.0","0","0","0","0","0","0","2","2","0","0","0","0","19","2"
"Adnan Januzaj","BEL","MF,FW","Las Palmas","6.6","10","6","1","6","3","5","9","4","6","0","6","2","3","0"
"Mikel Jauregizar","ESP","MF","Athletic Club","24.9","84","48","25","45","14","41","83","42","24","4","20","29","36","2"
"John Joe","IRL","MF,FW","Getafe","0.5","0","0","0","0","0","0","0","0","1","1","0","0","1","0"
"Jofre","ESP","MF,FW","Espanyol","24.1","22","16","14","5","3","13","23","10","13","0","13","15","29","0"
"Frenkie de Jong","NED","MF","Barcelona","12.7","19","11","5","8","6","8","16","8","9","1","8","12","7","1"
"Joan Jordán","ESP","MF","Alavés","15.7","32","18","11","17","4","17","30","13","12","0","12","9","21","0"
"Juanmi","ESP","FW,MF","Getafe","7.7","14","11","4","7","3","6","19","13","6","0","6","2","3","0"
"Juanmi","ESP","FW,MF","Betis","2.7","7","4","3","3","1","4","6","2","4","0","4","1","4","0"
"Juanpe","ESP","DF","Girona","8.1","8","5","5","3","0","6","8","2","15","10","5","8","56","1"
"Luiz Lúcio Reis Júnior","BRA","GK","Villarreal","16.2","0","0","0","0","0","0","0","0","0","0","0","0","14","1"
"Vinicius Júnior","BRA","FW","Real Madrid","25.0","21","10","7","4","10","5","18","13","9","0","9","3","1","2"
"Stanko Jurić","CRO","MF","Valladolid","19.2","48","24","26","19","3","19","48","29","35","11","24","24","52","0"
"Willy Kambwala","FRA","DF","Villarreal","12.4","17","12","14","2","1","10","12","2","10","7","3","10","56","1"
"Abdoulaye Keita","ESP","FW,MF","Getafe","1.1","2","2","0","1","1","2","4","2","1","0","1","0","3","0"
"Kenedy","BRA","MF,FW","Valladolid","0.1","0","0","0","0","0","0","0","0","1","0","1","0","0","0"
"Kiké","ESP","FW","Alavés","28.2","19","14","1","12","6","6","17","11","11","4","7","1","23","0"
"Koke","ESP","MF","Atlético Madrid","21.4","46","23","18","22","6","21","43","22","24","2","22","20","29","2"
"Jules Koundé","FRA","DF","Barcelona","28.9","63","43","29","23","11","44","66","22","35","5","30","20","68","2"
"Alex Král","CZE","MF","Espanyol","30.2","55","37","28","24","3","16","30","14","34","14","20","28","51","2"
"Ladislav Krejčí","CZE","DF","Girona","27.1","23","16","19","4","0","14","26","12","24","19","5","34","93","5"
"Takefusa Kubo","JPN","MF,FW","Real Sociedad","26.4","31","20","11","11","9","16","40","24","38","1","37","17","13","1"
"Marash Kumbulla","ALB","DF","Espanyol","33.0","51","26","35","14","2","24","41","17","48","35","13","34","224","2"
"Luca de la Torre","USA","MF","Celta Vigo","0.0","0","0","0","0","0","0","0","0","0","0","0","0","0","0"
"Yoel Lago","ESP","DF","Celta Vigo","6.5","12","8","8","3","1","7","9","2","5","4","1","4","30","0"
"Cyle Larin","CAN","FW","Mallorca","19.6","12","6","1","6","5","3","9","6","12","3","9","1","16","0"
"Juanmi Latasa","ESP","FW","Valladolid","15.5","4","2","1","1","2","2","6","4","4","1","3","0","11","1"
"Toni Lato","ESP","DF","Mallorca","6.9","17","11","6","5","6","7","11","4","10","4","6","6","33","0"
"Robin Le Normand","ESP","DF","Atlético Madrid","23.9","27","18","23","4","0","12","20","8","20","9","11","10","120","1"
"Florian Lejeune","FRA","DF","Rayo Vallecano","36.9","46","28","30","14","2","23","43","20","38","32","6","41","181","1"
"Iñigo Lekue","ESP","DF","Athletic Club","8.6","15","12","12","3","0","9","17","8","7","2","5","9","29","2"
"Thomas Lemar","FRA","MF","Atlético Madrid","0.9","2","1","1","1","0","2","4","2","0","0","0","0","1","0"
"Clément Lenglet","FRA","DF","Atlético Madrid","21.9","27","17","19","8","0","11","15","4","24","18","6","22","104","1"
"Robert Lewandowski","POL","FW","Barcelona","29.6","10","5","1","5","4","5","11","6","14","2","12","3","26","0"
"Samuel Lino","BRA","MF,DF","Atlético Madrid","17.2","33","17","25","4","4","22","52","30","23","4","19","8","13","0"
"Javier Llabrés","ESP","FW","Mallorca","0.6","0","0","0","0","0","0","0","0","1","0","1","0","0","0"
"Diego Llorente","ESP","DF","Betis","28.0","36","20","23","12","1","25","38","13","29","20","9","43","154","1"
"Marcos Llorente","ESP","DF,MF","Atlético Madrid","27.9","69","52","38","27","4","36","55","19","32","7","25","27","51","1"
"Giovani Lo Celso","ARG","MF,FW","Betis","16.2","34","22","8","17","9","17","25","8","14","2","12","5","3","1"
"Enzo Loiodice","FRA","MF","Las Palmas","7.6","17","7","8","9","0","3","10","7","4","1","3","10","7","2"
"David López","ESP","DF","Mallorca","1.9","3","2","3","0","0","2","2","0","2","2","0","1","10","0"
"David López","ESP","DF","Girona","27.0","32","24","22","7","3","18","31","13","22","12","10","14","111","2"
"Diego López","ESP","MF,FW","Valencia","30.4","31","18","11","16","4","16","47","31","30","0","30","16","15","0"
"Fer López",NA,"FW,MF","Celta Vigo","7.5","9","5","1","6","2","2","13","11","10","0","10","2","7","0"
"Fermin López","ESP","MF,FW","Barcelona","13.9","19","15","3","9","7","8","32","24","11","0","11","5","3","0"
"Javi López","ESP","DF","Real Sociedad","21.5","40","23","23","12","5","23","37","14","21","7","14","11","59","2"
"Pau López","ESP","GK","Girona","0.5","0","0","0","0","0","0","0","0","0","0","0","0","1","0"
"Roberto López","ESP","MF","Leganés","4.4","8","6","4","4","0","5","15","10","5","0","5","1","7","2"
"Unai López","ESP","MF","Rayo Vallecano","19.0","31","21","14","12","5","17","36","19","18","6","12","21","20","0"
"Iker Losada","ESP","FW,MF","Celta Vigo","4.0","3","3","0","1","2","1","5","4","4","1","3","1","8","0"
"Iker Losada","ESP","MF,FW","Betis","3.7","10","7","2","4","4","5","10","5","2","0","2","3","2","0"
"Pol Lozano","ESP","MF","Espanyol","21.6","53","34","23","25","5","25","58","33","32","6","26","22","31","0"
"José Luis Gayà","ESP","DF","Valencia","20.0","57","40","39","15","3","40","58","18","16","2","14","25","61","0"
"Dodi Lukebakio","BEL","FW","Sevilla","34.4","22","14","8","8","6","15","27","12","18","1","17","11","17","2"
"Daniel Luna","COL","MF","Mallorca","0.2","0","0","0","0","0","0","0","0","1","0","1","0","0","0"
"Andriy Lunin","UKR","GK","Real Madrid","7.0","1","0","1","0","0","0","0","0","0","0","0","0","3","0"
"Darwin Machís","VEN","MF,FW","Valladolid","7.1","5","4","3","2","0","3","9","6","3","0","3","5","13","0"
"Pablo Maffeo","ESP","DF","Mallorca","26.3","60","40","43","14","3","34","46","12","32","11","21","25","103","1"
"Jon Magunazelaia","ESP","MF","Real Sociedad","0.1","1","1","1","0","0","0","0","0","0","0","0","0","0","0"
"Giorgi Mamardashvili","GEO","GK","Valencia","34.0","2","2","2","0","0","2","3","1","0","0","0","1","16","3"
"Reinildo Mandava","MOZ","DF","Atlético Madrid","10.5","18","11","10","7","1","10","18","8","11","5","6","16","35","0"
"Javier Manquillo","ESP","DF","Celta Vigo","5.7","7","5","4","3","0","2","10","8","5","3","2","7","14","0"
"Marcão","BRA","DF","Sevilla","6.1","10","7","6","4","0","3","5","2","9","6","3","7","29","1"
"Óscar de Marcos","ESP","DF","Athletic Club","17.4","32","15","15","13","4","21","37","16","17","1","16","16","35","0"
"Alberto Marí","ESP","FW","Valencia","0.1","0","0","0","0","0","0","0","0","0","0","0","0","0","0"
"José María Giménez","URU","DF","Atlético Madrid","22.2","26","16","18","8","0","17","28","11","29","19","10","27","115","2"
"Arkaitz Mariezkurrena","ESP","FW,MF","Real Sociedad","2.7","1","0","1","0","0","0","4","4","4","1","3","1","4","0"
"Pablo Marín","ESP","MF","Real Sociedad","13.8","25","17","6","13","6","10","19","9","12","3","9","5","14","0"
"Mika Mármol","ESP","DF","Las Palmas","26.7","61","29","35","24","2","34","52","18","46","14","32","38","121","2"
"Mario Maroto","ESP","MF","Valladolid","0.7","0","0","0","0","0","0","2","2","0","0","0","2","2","0"
"Unai Marrero","ESP","GK","Real Sociedad","2.0","0","0","0","0","0","0","0","0","0","0","0","0","1","0"
"Carlos Martín","ESP","FW,MF","Alavés","14.8","43","21","18","16","9","13","49","36","30","1","29","5","20","0"
"Diego Martín","ESP","FW","Las Palmas","0.4","1","1","0","0","1","1","1","0","0","0","0","0","1","0"
"Gerard Martín","ESP","DF","Barcelona","11.5","22","10","10","7","5","11","16","5","16","2","14","13","27","0"
"Iván Martín","ESP","MF","Girona","22.7","32","19","14","14","4","15","34","19","20","6","14","11","15","1"
"Jon Martin","ESP","DF","Real Sociedad","10.0","11","9","7","3","1","6","9","3","13","9","4","7","80","1"
"Mario Martín","ESP","MF","Valladolid","19.4","62","32","31","27","4","21","49","28","32","7","25","21","46","7"
"Arnau Martinez","ESP","DF,MF","Girona","29.2","51","28","30","15","6","32","63","31","18","6","12","31","76","2"
"Iñigo Martínez","ESP","DF","Barcelona","27.7","25","14","20","5","0","16","22","6","18","7","11","18","108","1"
"Javi Martínez","ESP","MF","Osasuna","0.1","0","0","0","0","0","0","0","0","0","0","0","0","0","0"
"Ramón Martínez","ESP","DF","Sevilla","2.9","6","3","5","1","0","3","5","2","2","1","1","2","23","0"
"Toni Martínez","ESP","FW","Alavés","11.2","12","7","5","4","3","4","8","4","8","2","6","1","15","0"
"Javi Martón","ESP","FW,MF","Athletic Club","0.6","0","0","0","0","0","0","0","0","0","0","0","0","0","0"
"Marvin","ESP","DF,FW","Las Palmas","11.5","25","13","12","9","4","11","26","15","17","6","11","15","34","0"
"Omar Mascarell","EQG","MF","Mallorca","22.1","27","13","13","13","1","14","35","21","33","21","12","49","59","3"
"Jaime Mata","ESP","FW,MF","Las Palmas","7.3","8","2","2","6","0","3","9","6","5","1","4","3","11","0"
"Borja Mayoral","ESP","FW","Getafe","12.4","5","4","2","2","1","3","9","6","4","0","4","2","6","0"
"Kylian Mbappé","FRA","FW","Real Madrid","32.3","8","5","1","3","4","1","5","4","3","0","3","1","1","1"
"Oliver McBurnie","SCO","FW","Las Palmas","20.4","15","7","5","8","2","5","12","7","15","5","10","6","24","0"
"Scott McKenna","SCO","DF","Las Palmas","27.4","21","13","16","5","0","9","12","3","36","28","8","9","163","2"
"Mateo Mejía","ESP","FW","Sevilla","0.1","0","0","0","0","0","0","0","0","0","0","0","0","0","0"
"Arthur Melo","BRA","MF","Girona","10.5","25","11","8","12","5","14","27","13","5","1","4","8","12","1"
"Brais Méndez","ESP","MF","Real Sociedad","17.0","24","13","6","14","4","9","24","15","14","1","13","7","16","1"
"Ferland Mendy","FRA","DF","Real Madrid","11.2","17","14","7","6","4","9","12","3","11","4","7","9","8","1"
"Nobel Mendy","FRA","DF","Betis","1.2","0","0","0","0","0","0","0","0","2","0","2","4","10","1"
"Víctor Meseguer","ESP","MF","Valladolid","4.6","10","6","4","4","2","2","10","8","3","0","3","2","4","1"
"Miguel","ESP","FW","Leganés","19.2","16","7","6","4","6","4","14","10","15","4","11","4","23","1"
"Éder Militão","BRA","DF","Real Madrid","10.4","19","17","14","5","0","7","12","5","13","8","5","12","35","0"
"Luis Milla","ESP","MF","Getafe","31.9","61","40","28","25","8","35","72","37","25","0","25","24","28","3"
"Pere Milla","ESP","MF,FW","Espanyol","5.1","6","2","5","0","1","1","18","17","10","2","8","3","5","0"
"Óscar Mingueza","ESP","MF,DF","Celta Vigo","30.3","38","24","21","12","5","26","69","43","35","5","30","22","46","7"
"Kim Minsu","KOR","MF,FW","Girona","0.2","1","0","0","1","0","0","0","0","0","0","0","0","0","0"
"Bojan Miovski","MKD","FW","Girona","9.7","7","5","2","2","3","2","7","5","4","0","4","2","7","0"
"Rafa Mir","ESP","FW,MF","Valencia","8.4","12","6","8","4","0","3","9","6","5","0","5","5","9","0"
"Luka Modrić","CRO","MF","Real Madrid","20.3","31","20","16","13","2","14","32","18","17","5","12","27","17","0"
"Johan Mojica","COL","DF","Mallorca","30.6","35","23","26","6","3","19","40","21","13","5","8","26","84","3"
"Alberto Moleiro","ESP","FW,MF","Las Palmas","30.2","27","12","12","14","1","18","48","30","24","0","24","18","8","0"
"Nahuel Molina","ARG","DF","Atlético Madrid","17.7","44","19","21","21","2","31","56","25","16","3","13","13","53","0"
"Jon Moncayola","ESP","MF","Osasuna","23.3","70","41","29","33","8","31","60","29","34","3","31","11","20","0"
"Gonzalo Montiel","ARG","DF,MF","Sevilla","1.3","4","2","3","1","0","3","4","1","0","0","0","2","11","0"
"Gerard Moreno","ESP","FW","Villarreal","8.0","7","4","3","2","2","3","12","9","0","0","0","2","8","0"
"Xavier Moreno","ESP","FW","Valladolid","0.5","0","0","0","0","0","0","0","0","0","0","0","0","1","0"
"Mateu Morey","ESP","DF","Mallorca","8.2","22","18","13","6","3","12","22","10","11","0","11","15","32","2"
"Ilaix Moriba","GUI","MF","Celta Vigo","23.7","68","42","24","30","14","32","57","25","29","4","25","14","33","1"
"Manu Morlanes","ESP","MF","Mallorca","14.9","43","27","18","20","5","18","30","12","19","8","11","24","16","0"
"Raúl Moro","ESP","MF,FW","Valladolid","26.0","22","13","15","4","3","13","32","19","8","0","8","10","20","1"
"Cristhian Mosquera","ESP","DF","Valencia","36.9","56","36","41","13","2","31","40","9","37","24","13","35","128","4"
"Santiago Mouriño","URU","DF","Alavés","20.5","43","28","31","12","0","21","38","17","27","12","15","29","120","0"
"Abdul Mumin","GHA","DF","Rayo Vallecano","22.4","37","25","30","7","0","17","27","10","40","29","11","23","125","0"
"Aihen Muñoz","ESP","DF","Real Sociedad","12.2","24","12","14","8","2","14","28","14","11","6","5","14","47","0"
"Álex Muñoz","ESP","DF","Las Palmas","15.7","39","29","22","16","1","21","38","17","28","11","17","16","69","0"
"Iker Muñoz","ESP","MF","Osasuna","6.8","5","2","3","2","0","3","9","6","9","2","7","4","12","1"
"Javier Muñoz","ESP","MF,DF","Las Palmas","28.8","45","35","18","17","10","16","46","30","27","4","23","31","39","3"
"Víctor Muñoz","ESP","FW,DF","Real Madrid","0.4","0","0","0","0","0","0","0","0","0","0","0","0","0","0"
"Vedat Muriqi","KVX","FW","Mallorca","22.9","7","5","3","2","2","3","7","4","7","1","6","7","43","0"
"Juan Musso","ARG","GK","Atlético Madrid","2.0","0","0","0","0","0","0","0","0","0","0","0","0","0","0"
"Matija Nastasić","SRB","DF","Leganés","23.4","25","11","21","4","0","17","25","8","39","30","9","21","165","0"
"Natan","BRA","DF","Betis","24.2","35","24","24","9","2","26","30","4","24","14","10","28","123","2"
"Pau Navarro","ESP","DF","Villarreal","10.2","23","17","15","6","2","19","39","20","13","6","7","4","41","0"
"Roberto Navarro","ESP","MF,FW","Mallorca","14.2","29","22","14","11","4","9","19","10","18","0","18","19","12","0"
"Jesús Navas","ESP","FW,MF","Sevilla","4.7","5","2","3","0","2","0","3","3","1","0","1","4","6","0"
"Yvan Neyou","CMR","MF","Leganés","25.7","53","33","21","26","6","22","47","25","35","5","30","26","38","1"
"Tanguy Nianzou","FRA","DF","Sevilla","5.8","7","5","6","0","1","5","6","1","1","0","1","8","27","0"
"Saúl Ñíguez","ESP","MF","Sevilla","17.3","47","32","16","24","7","12","31","19","25","2","23","22","34","0"
"Tamás Nikitscher","HUN","MF,DF","Valladolid","9.5","17","8","8","9","0","8","13","5","17","4","13","11","16","1"
"Adrian Niño","ESP","FW","Atlético Madrid","0.1","0","0","0","0","0","0","0","0","0","0","0","0","0","0"
"Hugo Novoa","ESP","DF,MF","Alavés","2.6","8","5","4","3","1","5","5","0","2","1","1","0","6","0"
"Randy Nteka","ANG","FW","Rayo Vallecano","12.5","16","5","3","9","4","5","12","7","13","2","11","4","20","0"
"Unai Núñez","ESP","DF","Athletic Club","7.2","10","5","7","3","0","4","7","3","4","4","0","17","46","1"
"Ørjan Nyland","NOR","GK","Sevilla","29.7","3","2","3","0","0","3","5","2","0","0","0","0","12","4"
"Allan Nyom","CMR","DF,MF","Getafe","9.9","18","11","7","9","2","15","17","2","4","2","2","4","23","0"
"Jan Oblak","SVN","GK","Atlético Madrid","36.0","0","0","0","0","0","0","0","0","0","0","0","0","17","2"
"Lucas Ocampos","ARG","FW","Sevilla","1.9","3","2","2","0","1","1","2","1","2","0","2","0","2","0"
"Álvaro Odriozola","ESP","DF","Real Sociedad","0.5","1","1","1","0","0","0","0","0","0","0","0","0","1","0"
"Thiago Ojeda","ARG","MF","Villarreal","0.1","0","0","0","0","0","0","0","0","0","0","0","0","1","0"
"Aingeru Olabarrieta","ESP","FW","Athletic Club","0.6","0","0","0","0","0","0","0","0","2","0","2","1","1","0"
"Olasagasti","ESP","MF","Real Sociedad","9.5","21","10","7","9","5","8","18","10","8","2","6","15","10","0"
"Brian Oliván","ESP","DF","Espanyol","11.3","13","10","7","6","0","4","13","9","6","2","4","10","23","0"
"Lucas Oliveira Rosa","BRA","DF","Valladolid","21.0","53","33","40","11","2","35","51","16","24","9","15","28","69","2"
"Dani Olmo","ESP","MF,FW","Barcelona","13.5","16","11","8","5","3","4","14","10","6","3","3","3","11","1"
"Aimar Oroz","ESP","MF","Osasuna","33.0","35","19","16","13","6","14","46","32","29","2","27","20","10","0"
"Ángel Ortíz","ESP","DF","Betis","3.9","12","8","8","3","1","8","17","9","6","0","6","5","7","0"
"Gabriel Osei Misehouy","NED","FW,MF","Girona","2.9","1","1","0","1","0","0","1","1","0","0","0","0","0","0"
"David Otorbi","ESP","MF","Valencia","0.2","0","0","0","0","0","0","0","0","1","0","1","0","0","0"
"Jesús Owono","EQG","GK","Alavés","5.4","1","1","1","0","0","1","1","0","0","0","0","0","2","0"
"Mikel Oyarzabal","ESP","FW","Real Sociedad","25.0","25","16","9","10","6","10","23","13","17","1","16","4","15","0"
"Cenk Özkacar","TUR","DF","Valladolid","8.4","9","5","7","2","0","4","14","10","9","6","3","18","69","1"
"Jon Pacheco","ESP","DF","Real Sociedad","9.5","15","9","12","3","0","10","12","2","8","6","2","9","49","2"
"Alex Padilla","ESP","GK","Athletic Club","3.6","0","0","0","0","0","0","0","0","0","0","0","0","2","1"
"Isaac Palazón Camacho","ESP","MF,FW","Rayo Vallecano","24.0","22","17","10","6","6","8","34","26","22","3","19","8","13","1"
"Aitor Paredes","ESP","DF","Athletic Club","20.1","15","13","10","5","0","8","15","7","26","15","11","22","114","4"
"Daniel Parejo","ESP","MF","Villarreal","25.3","52","40","27","20","5","29","54","25","24","7","17","24","40","1"
"Iago Parente","ESP","DF","Valladolid","0.8","0","0","0","0","0","0","0","0","0","0","0","0","2","0"
"Álvaro Pascual","ESP","FW","Sevilla","4.5","5","3","0","3","2","1","5","4","4","0","4","2","9","0"
"Alfonso Pedraza","ESP","DF,MF","Villarreal","5.1","3","2","2","0","1","2","4","2","3","1","2","6","16","0"
"Pedri","ESP","MF","Barcelona","32.0","61","34","14","38","9","24","70","46","45","3","42","26","21","1"
"Adrià Pedrosa","ESP","DF","Sevilla","25.5","56","32","34","16","6","31","54","23","43","11","32","24","85","0"
"Pejiño","ESP","FW","Las Palmas","0.2","1","1","0","1","0","1","1","0","0","0","0","0","0","0"
"Andy Pelmard","FRA","DF","Las Palmas","2.3","5","0","3","2","0","4","5","1","3","1","2","2","20","0"
"Iñaki Peña","ESP","GK","Barcelona","15.5","0","0","0","0","0","0","2","2","0","0","0","0","20","1"
"Rubén Peña","ESP","FW,DF","Osasuna","8.6","12","5","4","3","5","5","24","19","11","0","11","6","12","0"
"Nicolas Pépé","CIV","FW,MF","Villarreal","16.7","22","9","12","6","4","6","17","11","12","1","11","5","12","0"
"Peque","ESP","MF,FW","Sevilla","12.6","16","5","4","10","2","7","17","10","16","0","16","8","5","0"
"Ayoze Pérez","ESP","FW","Villarreal","21.9","27","14","5","18","4","6","24","18","17","0","17","8","15","0"
"Carles Pérez","ESP","MF,FW","Getafe","15.9","33","23","11","14","8","21","48","27","19","2","17","6","22","0"
"Francisco Perez","ESP","FW,MF","Valencia","6.3","17","12","7","8","2","10","16","6","8","1","7","3","6","0"
"Kike Pérez","ESP","MF","Valladolid","13.2","37","26","15","19","3","15","26","11","16","4","12","7","18","0"
"Luis Pérez","ESP","DF","Valladolid","28.4","41","30","25","11","5","24","40","16","26","9","17","29","86","0"
"Romain Perraud","FRA","DF","Betis","22.2","36","22","15","16","5","21","46","25","18","4","14","22","71","1"
"Valentín Pezzolesi","ESP","DF","Las Palmas","0.1","0","0","0","0","0","0","0","0","0","0","0","0","1","1"
"Pica","ESP","DF","Alavés","5.5","9","7","7","2","0","4","9","5","7","6","1","9","26","0"
"Yeremi Pino","ESP","MF,FW","Villarreal","21.5","60","32","20","32","8","32","65","33","38","3","35","8","18","0"
"Portu","ESP","FW,MF","Girona","8.7","13","7","5","5","3","7","10","3","8","0","8","0","2","0"
"Beñat Prados","ESP","MF","Athletic Club","19.1","55","36","20","27","8","25","53","28","21","2","19","28","26","0"
"Abdón Prats","ESP","FW,MF","Mallorca","5.1","2","1","1","1","0","1","2","1","2","1","1","1","5","0"
"Javi Puado","ESP","FW,MF","Espanyol","33.0","22","17","14","4","4","8","20","12","18","3","15","5","19","0"
"Dani Raba","ESP","FW,MF","Leganés","20.9","37","23","17","15","5","17","42","25","27","3","24","14","19","1"
"Arnau Rafús","ESP","GK","Valladolid","1.0","0","0","0","0","0","0","0","0","0","0","0","0","0","1"
"Antonio Raillo","ESP","DF","Mallorca","35.6","31","18","18","10","3","14","20","6","51","38","13","29","222","1"
"Benito Ramírez","ESP","DF,FW","Las Palmas","5.3","10","5","4","6","0","9","16","7","8","3","5","1","14","1"
"Sandro Ramírez","ESP","FW,MF","Las Palmas","22.6","27","15","10","13","4","13","30","17","20","0","20","16","22","2"
"Jacobo Ramón","ESP","DF","Real Madrid","2.3","7","3","4","3","0","2","2","0","1","0","1","3","8","2"
"Raphinha","BRA","FW,MF","Barcelona","31.5","36","22","6","19","11","19","39","20","29","2","27","11","26","0"
"Andrei Ratiu","ROU","DF","Rayo Vallecano","34.1","71","41","40","21","10","42","70","28","45","5","40","27","73","2"
"Raúl","ESP","FW,MF","Osasuna","8.3","13","8","3","6","4","5","10","5","4","0","4","0","6","0"
"Abderrahman Rebbach","ALG","FW,MF","Alavés","4.3","3","2","3","0","0","0","6","6","4","0","4","0","6","0"
"Álex Remiro","ESP","GK","Real Sociedad","36.0","1","0","1","0","0","1","2","1","0","0","0","0","18","4"
"Daniel Requena","ESP","MF","Villarreal","0.1","0","0","0","0","0","0","0","0","0","0","0","0","0","0"
"Diego Rico","ESP","DF","Getafe","31.3","81","49","47","29","5","47","85","38","41","3","38","34","102","2"
"Luis Rioja","ESP","FW","Alavés","0.3","2","1","0","1","1","1","2","1","2","0","2","0","0","0"
"Luis Rioja","ESP","MF,FW","Valencia","31.5","33","21","14","12","7","14","42","28","30","1","29","22","44","1"
"Rodrigo Riquelme","ESP","MF,DF","Atlético Madrid","5.7","11","5","4","6","1","6","11","5","3","0","3","2","3","0"
"Alberto Risco","ESP","MF,FW","Getafe","0.8","4","4","2","0","2","1","6","5","2","0","2","0","0","0"
"Mihailo Ristić","SRB","DF,MF","Celta Vigo","4.8","7","7","4","2","1","4","6","2","1","0","1","2","18","0"
"Gorka Rivera Alonso","ESP","DF,MF","Getafe","0.2","2","0","0","2","0","2","2","0","0","0","0","0","0","0"
"Marc Roca","ESP","MF","Betis","10.1","20","14","10","9","1","9","17","8","17","5","12","14","14","2"
"Rodri","ESP","FW","Betis","1.3","2","1","1","1","0","1","2","1","2","1","1","1","1","1"
"Adrian Rodriguez","ESP","GK","Alavés","1.4","0","0","0","0","0","0","1","1","0","0","0","0","3","1"
"Álvaro Rodríguez","URU","FW","Getafe","9.5","10","7","0","7","3","5","10","5","23","0","23","3","12","0"
"Óscar Rodríguez Arnaiz","ESP","MF,FW","Leganés","14.8","32","17","10","16","6","14","32","18","10","1","9","20","20","0"
"Arturo Rodríguez","ESP","FW","Las Palmas","0.2","0","0","0","0","0","0","0","0","0","0","0","0","0","0"
"Damián Rodríguez","ESP","MF","Celta Vigo","10.3","14","9","3","10","1","6","16","10","6","1","5","7","13","0"
"Dani Rodríguez","ESP","MF,FW","Mallorca","24.0","49","29","18","21","10","14","27","13","22","3","19","12","30","0"
"Daniel Rodriguez","ESP","FW","Barcelona","0.4","0","0","0","0","0","0","0","0","1","0","1","0","0","0"
"James Rodríguez","COL","MF,FW","Rayo Vallecano","1.6","3","2","1","2","0","0","2","2","2","0","2","1","0","0"
"Javi Rodríguez","ESP","DF","Celta Vigo","27.9","53","38","35","17","1","33","47","14","29","10","19","33","96","2"
"Jesus Rodríguez","ESP","FW","Betis","12.3","16","14","6","6","4","5","18","13","16","0","16","6","3","0"
"Kirian Rodríguez","ESP","MF","Las Palmas","19.5","33","17","12","18","3","22","43","21","22","4","18","10","21","0"
"Ricardo Rodríguez","SUI","DF","Betis","14.2","28","15","16","5","7","17","26","9","10","1","9","8","51","0"
"Rodrygo","BRA","FW,MF","Real Madrid","21.4","21","14","14","5","2","7","23","16","18","1","17","11","9","0"
"Leo Román","ESP","GK","Mallorca","7.0","0","0","0","0","0","0","0","0","0","0","0","0","6","0"
"Carlos Romero","ESP","DF","Espanyol","28.4","73","47","49","16","8","45","82","37","50","15","35","30","102","1"
"Isaac Romero","ESP","FW","Sevilla","24.0","13","7","4","4","5","3","16","13","18","1","17","7","27","0"
"Luka Romero","ARG","FW,MF","Alavés","2.2","4","4","1","1","2","2","3","1","2","0","2","1","0","0"
"Oriol Romeu","ESP","MF","Girona","15.1","38","25","14","19","5","14","26","12","22","8","14","12","20","4"
"Vitor Roque","BRA","FW","Betis","13.7","11","6","1","6","4","1","5","4","5","0","5","7","4","0"
"Valentin Rosier","FRA","DF","Leganés","28.8","72","52","48","16","8","43","68","25","40","15","25","52","149","2"
"Antonio Rüdiger","GER","DF","Real Madrid","25.5","20","13","14","6","0","11","15","4","22","14","8","9","96","1"
"Aitor Ruibal","ESP","DF,FW","Betis","14.6","32","23","22","4","6","25","47","22","20","5","15","14","40","1"
"Abel Ruiz","ESP","FW","Girona","15.0","6","2","2","2","2","2","5","3","7","2","5","5","7","0"
"Ferrán Ruiz","ESP","MF","Girona","0.2","0","0","0","0","0","0","0","0","2","1","1","1","0","0"
"Youssouf Sabaly","SEN","DF","Betis","17.6","40","25","21","15","4","24","32","8","21","4","17","13","40","0"
"Umar Sadiq","NGA","FW","Valencia","9.2","10","5","3","5","2","4","6","2","7","0","7","1","7","0"
"Umar Sadiq","NGA","FW","Real Sociedad","2.5","2","1","1","1","0","1","2","1","3","1","2","1","2","0"
"Jorge Sáenz","ESP","DF","Leganés","18.8","37","23","18","18","1","11","20","9","26","17","9","25","161","0"
"Jan Salas","ESP","MF,FW","Mallorca","0.5","3","1","2","1","0","2","2","0","0","0","0","0","0","0"
"Kike Salas","ESP","DF","Sevilla","24.9","47","28","24","16","7","27","46","19","26","14","12","32","146","0"
"Albert Sambi Lokonga","BEL","MF","Sevilla","16.3","22","15","10","9","3","10","14","4","13","1","12","9","24","3"
"Chuky san jose","ESP","MF","Valladolid","8.1","8","2","3","3","2","2","9","7","4","1","3","0","4","0"
"Oihan Sancet","ESP","MF","Athletic Club","18.0","13","8","6","6","1","5","14","9","10","0","10","5","6","0"
"Antonio Sánchez","ESP","MF,DF","Mallorca","15.5","28","16","16","8","4","14","36","22","16","2","14","18","36","1"
"Iván Sánchez","ESP","MF,FW","Valladolid","15.6","37","20","18","10","9","12","27","15","18","3","15","14","10","0"
"Javi Sánchez","ESP","DF","Valladolid","22.5","26","16","19","6","1","17","26","9","39","28","11","22","111","3"
"Juanlu Sánchez","ESP","MF,DF","Sevilla","19.1","50","34","28","15","7","35","59","24","27","2","25","17","19","0"
"Manu Sánchez","ESP","DF","Alavés","29.3","83","56","40","33","10","41","69","28","51","12","39","30","76","1"
"Maroan Sannadi","MAR","FW","Athletic Club","8.4","5","0","1","4","0","2","7","5","1","0","1","1","2","1"
"Jesús Santiago","ESP","MF","Getafe","4.1","14","8","6","8","0","5","10","5","6","2","4","1","3","0"
"Aleksandar Sedlar","SRB","DF","Alavés","6.6","18","10","7","11","0","8","10","2","2","1","1","10","24","1"
"Sergi","ESP","DF","Leganés","32.9","40","29","22","16","2","18","32","14","38","29","9","39","185","2"
"Nicolás Serrano","ESP","FW","Athletic Club","1.2","1","1","0","1","0","1","3","2","4","0","4","1","1","0"
"Fábio Silva","POR","FW","Las Palmas","20.7","12","7","4","5","3","4","14","10","12","0","12","4","27","0"
"Rui Silva","POR","GK","Betis","15.0","0","0","0","0","0","0","1","1","1","0","1","0","7","0"
"Giuliano Simeone","ARG","MF","Atlético Madrid","21.4","27","13","6","11","10","15","30","15","22","3","19","14","22","1"
"Unai Simón","ESP","GK","Athletic Club","21.0","0","0","0","0","0","0","0","0","1","0","1","1","14","4"
"Daley Sinkgraven","NED","DF","Las Palmas","1.0","5","1","3","2","0","1","3","2","1","0","1","1","2","0"
"Jailson Siqueira","BRA","DF,MF","Celta Vigo","6.8","13","11","9","3","1","9","11","2","6","4","2","9","28","1"
"Antonio Sivera","ESP","GK","Alavés","31.2","2","1","2","0","0","2","2","0","1","0","1","0","20","0"
"Justin Smith","CAN","MF","Espanyol","2.3","9","3","3","6","0","4","6","2","5","1","4","4","3","0"
"Alex Sola","ESP","MF,FW","Getafe","11.4","21","14","9","12","0","9","25","16","8","0","8","7","11","1"
"Arnau Solà","ESP","MF","Villarreal","0.1","0","0","0","0","0","0","2","2","1","1","0","0","0","0"
"Jhon Solis","COL","MF","Girona","5.9","13","7","3","9","1","6","14","8","13","1","12","4","6","1"
"David Soria","ESP","GK","Getafe","38.0","4","4","4","0","0","4","5","1","0","0","0","1","21","3"
"Juan Soriano","ESP","GK","Leganés","6.0","1","1","1","0","0","1","1","0","0","0","0","0","2","0"
"Hugo Sotelo","ESP","MF","Celta Vigo","13.9","28","17","8","10","10","13","31","18","9","1","8","5","9","1"
"Djibril Sow","SUI","MF","Sevilla","22.9","25","14","13","10","2","8","17","9","18","3","15","28","26","1"
"Carl Starfelt","SWE","DF","Celta Vigo","25.2","40","20","25","14","1","18","27","9","29","21","8","31","129","3"
"Orri Steinn Óskarsson","ISL","FW","Real Sociedad","10.5","6","6","2","1","3","2","8","6","10","1","9","2","11","0"
"Stoichkov","ESP","MF,FW","Alavés","7.8","14","9","6","7","1","6","11","5","2","0","2","1","7","0"
"Cristhian Stuani","URU","FW","Girona","12.0","9","7","1","7","1","5","8","3","4","1","3","7","11","0"
"Álex Suárez","ESP","DF","Las Palmas","27.3","40","23","30","9","1","20","27","7","39","24","15","13","107","2"
"Denis Suárez","ESP","MF","Villarreal","6.8","12","8","7","2","3","4","10","6","4","1","3","3","3","0"
"Luka Sučić","CRO","MF","Real Sociedad","19.9","25","18","8","12","5","10","26","16","30","2","28","15","16","1"
"Suso","ESP","FW,MF","Sevilla","6.7","10","7","3","6","1","4","11","7","4","0","4","4","2","0"
"Williot Swedberg","SWE","FW,MF","Celta Vigo","15.0","23","16","9","10","4","13","20","7","12","1","11","3","10","1"
"Mamadou Sylla","SEN","FW,MF","Valladolid","17.6","8","4","3","3","2","2","9","7","8","0","8","3","14","1"
"Wojciech Szczęsny","POL","GK","Barcelona","15.0","1","1","1","0","0","0","0","0","0","0","0","0","20","1"
"Alexander Sørloth","NOR","FW","Atlético Madrid","17.4","9","5","2","5","2","3","6","3","6","1","5","1","28","0"
"Renato Tapia","PER","MF,DF","Leganés","26.9","61","35","30","27","4","24","50","26","58","23","35","27","86","2"
"César Tárrega","ESP","DF","Valencia","33.6","49","37","33","13","3","19","31","12","41","20","21","22","222","2"
"Aurélien Tchouaméni","FRA","DF,MF","Real Madrid","29.9","47","23","25","19","3","21","41","20","34","25","9","46","92","1"
"Álvaro Tejero","ESP","MF,DF","Espanyol","13.8","14","4","7","6","1","7","23","16","9","1","8","13","34","1"
"Martín Tejón","ESP","MF,DF","Valencia","0.5","2","0","0","2","0","1","2","1","0","0","0","0","0","0"
"Nahuel Tenaglia","ARG","DF","Alavés","32.5","96","61","61","30","5","53","88","35","33","9","24","47","123","2"
"Marc-André ter Stegen","GER","GK","Barcelona","7.5","0","0","0","0","0","0","1","1","0","0","0","0","2","2"
"Ramón Terrats","ESP","MF,FW","Villarreal","1.5","3","3","1","2","0","2","4","2","3","1","2","2","3","0"
"Ramón Terrats","ESP","MF,FW","Getafe","13.5","20","10","7","8","5","8","28","20","9","2","7","8","16","0"
"Raúl de Tomás","ESP","DF,FW","Rayo Vallecano","0.2","2","2","1","0","1","0","0","0","0","0","0","0","0","0"
"Pablo Torre","ESP","MF,FW","Barcelona","3.4","5","4","1","3","1","2","4","2","0","0","0","3","5","1"
"David Torres","ESP","DF","Valladolid","15.4","13","8","12","1","0","7","11","4","19","17","2","10","74","0"
"Ferrán Torres","ESP","FW,MF","Barcelona","12.3","8","4","2","3","3","3","8","5","7","1","6","4","5","0"
"Lucas Torró","ESP","MF","Osasuna","32.9","74","41","34","35","5","36","64","28","36","9","27","45","70","3"
"Hamari Traoré","MLI","DF","Real Sociedad","7.8","19","12","10","7","2","15","22","7","6","2","4","9","21","0"
"Óscar Trejo","ARG","MF","Rayo Vallecano","5.5","8","5","1","5","2","3","9","6","9","0","9","4","5","0"
"Viktor Tsyhankov","UKR","FW,MF","Girona","21.3","19","12","4","7","8","9","19","10","7","1","6","15","16","1"
"Beñat Turrientes","ESP","MF","Real Sociedad","10.5","15","6","4","10","1","4","15","11","15","3","12","5","14","1"
"Christantus Uche","NGA","FW,MF","Getafe","27.6","35","21","8","19","8","9","20","11","20","2","18","10","19","0"
"Naci Ünüvar","NED","MF,DF","Espanyol","0.3","2","2","1","1","0","1","2","1","0","0","0","0","0","0"
"Óscar Valentín","ESP","MF","Rayo Vallecano","20.4","55","41","21","20","14","33","76","43","36","8","28","21","51","2"
"Germán Valera","ESP","MF","Valencia","1.6","1","1","1","0","0","0","1","1","2","0","2","4","2","1"
"Martin Valjent","SVK","DF","Mallorca","30.7","30","21","22","7","1","15","25","10","32","21","11","18","195","1"
"Jesús Vallejo","ESP","DF","Real Madrid","1.5","0","0","0","0","0","0","0","0","0","0","0","2","8","0"
"Federico Valverde","URU","MF,DF","Real Madrid","33.7","50","30","22","23","5","29","43","14","38","8","30","55","52","1"
"Siebe Van Der Heyden","BEL","DF,MF","Mallorca","1.1","1","1","0","1","0","0","0","0","1","0","1","2","3","0"
"Ruben Vargas","SUI","FW,MF","Sevilla","7.5","7","4","1","5","1","3","8","5","9","0","9","3","10","0"
"José Luis García Vayá","ESP","MF","Valencia","19.4","43","25","24","13","6","19","33","14","23","6","17","19","42","0"
"Jesus Vazquez","ESP","DF","Valencia","10.2","23","18","12","9","2","10","19","9","16","5","11","10","30","0"
"Lucas Vázquez","ESP","DF","Real Madrid","24.3","58","34","33","17","8","27","48","21","24","6","18","17","35","1"
"Alejo Véliz","ARG","FW","Espanyol","12.5","1","1","0","1","0","1","7","6","12","2","10","4","23","1"
"Mikel Vesga","ESP","MF","Athletic Club","11.0","22","15","7","13","2","12","28","16","10","1","9","15","26","0"
"Carlos Vicente","ESP","FW,MF","Alavés","34.4","47","31","26","11","10","25","64","39","34","2","32","14","40","0"
"Pau Victor","ESP","FW","Barcelona","3.5","3","1","0","2","1","0","3","3","6","1","5","2","5","0"
"Nacho Vidal","ESP","DF","Osasuna","1.4","2","0","0","1","1","1","4","3","1","0","1","0","6","0"
"Fran Vieites","ESP","GK","Betis","4.0","0","0","0","0","0","0","0","0","0","0","0","0","1","0"
"Sergio Viera","ESP","MF","Las Palmas","1.1","1","1","0","1","0","0","1","1","1","0","1","1","1","0"
"Asier Villalibre","ESP","FW","Alavés","3.7","2","2","0","1","1","1","2","1","1","0","1","1","7","0"
"Iván Villar","ESP","GK","Celta Vigo","4.0","0","0","0","0","0","0","0","0","0","0","0","0","3","0"
"Viti","ESP","DF","Las Palmas","22.0","71","46","43","21","7","31","45","14","28","7","21","27","61","0"
"Daniel Vivian","ESP","DF","Athletic Club","29.0","40","26","23","14","3","21","32","11","26","10","16","47","152","2"
"Krapyvtsov Vladyslav","UKR","GK","Girona","2.0","0","0","0","0","0","0","0","0","0","0","0","0","1","1"
"Iñaki Williams","GHA","FW","Athletic Club","29.5","17","10","4","8","5","12","23","11","34","5","29","12","32","0"
"Nico Williams","ESP","FW","Athletic Club","22.2","28","18","10","11","7","11","32","21","20","1","19","7","9","0"
"Axel Witsel","BEL","DF","Atlético Madrid","9.5","16","12","4","10","2","12","14","2","15","8","7","11","34","1"
"Lamine Yamal","ESP","FW","Barcelona","31.7","42","28","8","17","17","16","38","22","12","0","12","16","3","0"
"Daniel Yáñez","ESP","FW","Real Madrid","0.0","0","0","0","0","0","0","0","0","0","0","0","0","0","0"
"Bertuğ Yıldırım","TUR","FW","Getafe","12.0","10","5","0","7","3","2","7","5","13","2","11","1","16","0"
"Arsen Zakharyan","RUS","MF,FW","Real Sociedad","0.8","1","1","1","0","0","1","1","0","1","1","0","1","0","0"
"Bryan Zaragoza","ESP","FW,MF","Osasuna","20.4","13","9","8","4","1","6","21","15","10","0","10","4","8","0"
"Igor Zubeldia","ESP","DF","Real Sociedad","25.2","34","22","21","10","3","14","26","12","32","18","14","31","100","2"
"Martín Zubimendi","ESP","MF","Real Sociedad","32.9","73","37","31","29","13","28","44","16","42","16","26","44","79","3"
"James Abankwah","IRL","DF,MF","Udinese","1.0","4","2","4","0","0","2","3","1","2","1","1","1","3","0"
"Saud Abdulhamid","KSA","DF","Roma","2.3","3","2","2","0","1","1","1","0","2","0","2","2","0","0"
"Oliver Abildgaard","DEN","MF","Como","0.1","0","0","0","0","0","0","0","0","1","0","1","0","0","0"
"Tammy Abraham","ENG","FW","Roma","0.0","0","0","0","0","0","0","1","1","0","0","0","0","0","0"
"Tammy Abraham","ENG","FW","Milan","13.1","17","11","2","10","5","6","8","2","13","0","13","2","16","0"
"Federico Accornero","ITA","MF","Genoa","0.1","0","0","0","0","0","0","0","0","0","0","0","0","0","0"
"Francesco Acerbi","ITA","DF","Inter","19.0","23","19","16","7","0","11","17","6","22","16","6","26","81","0"
"Che Adams","SCO","FW","Torino","29.5","12","6","2","4","6","1","7","6","13","6","7","2","18","0"
"Yacine Adli","FRA","MF","Fiorentina","13.5","32","19","11","16","5","17","39","22","13","1","12","6","19","0"
"Vasilije Adžić","MNE","MF,FW","Juventus","0.5","2","2","0","1","1","0","1","1","0","0","0","0","0","0"
"Michel Aebischer","SUI","MF","Bologna","8.0","18","13","8","7","3","10","14","4","4","1","3","7","6","0"
"Honest Ahanor","ITA","DF,MF","Genoa","3.0","7","5","2","3","2","7","10","3","4","0","4","1","9","0"
"Junior Ajayi","CIV","FW","Hellas Verona","0.1","0","0","0","0","0","0","0","0","0","0","0","0","0","0"
"Jean-Daniel Akpa-Akpro","CIV","MF","Monza","10.7","30","18","15","14","1","9","21","12","19","6","13","13","16","1"
"David Akpan Ankeye","NGA","FW,MF","Genoa","0.5","0","0","0","0","0","0","1","1","0","0","0","0","1","0"
"Faride Alidou","GER","FW,MF","Hellas Verona","0.8","0","0","0","0","0","0","0","0","1","0","1","1","3","1"
"Dele Alli","ENG","MF","Como","0.1","0","0","0","0","0","0","0","0","0","0","0","0","0","0"
"Pontus Almqvist","SWE","FW,MF","Parma","12.4","17","13","7","7","3","8","17","9","13","0","13","19","8","0"
"Giorgio Altare","ITA","DF","Venezia","8.4","13","12","8","3","2","8","15","7","21","11","10","17","49","0"
"Sofyan Amrabat","MAR","MF","Fiorentina","2.0","3","2","1","2","0","2","2","0","1","1","0","0","2","0"
"Angeliño","ESP","DF","Roma","35.3","46","24","20","24","2","17","34","17","33","9","24","28","98","0"
"Lorenzo Anghelè","ITA","FW","Juventus","0.1","0","0","0","0","0","0","0","0","0","0","0","0","0","0"
"Faustino Anjorin","ENG","MF","Empoli","12.4","29","13","9","14","6","9","18","9","18","3","15","13","20","0"
"Marko Arnautović","AUT","FW","Inter","5.9","7","5","1","3","3","3","5","2","3","0","3","1","1","0"
"Kristjan Asllani","ALB","MF","Inter","10.9","14","3","8","4","2","8","22","14","8","1","7","9","13","1"
"Arthur Atta","FRA","MF,FW","Udinese","13.9","20","12","9","10","1","10","15","5","9","5","4","7","15","1"
"Emil Audero","IDN","GK","Como","8.0","0","0","0","0","0","0","1","1","0","0","0","0","4","1"
"Tommaso Augello","ITA","DF","Cagliari","30.1","49","28","28","17","4","30","43","13","23","8","15","16","109","2"
"Carlos Augusto","BRA","DF","Inter","18.1","29","14","12","11","6","12","19","7","21","9","12","9","50","0"
"Yann Aurel Bisseck","GER","DF","Inter","17.3","17","11","11","4","2","11","16","5","23","12","11","17","64","1"
"Paulo Azzi","BRA","DF","Cagliari","4.7","11","9","3","6","2","5","9","4","5","2","3","5","11","0"
"Oussama El Azzouzi","MAR","MF","Bologna","0.2","0","0","0","0","0","0","0","0","0","0","0","2","0","0"
"Jacopo Bacci","ITA","MF","Empoli","0.3","1","0","1","0","0","1","1","0","0","0","0","1","1","0"
"Milan Badelj","CRO","MF","Genoa","16.4","29","16","14","10","5","15","35","20","19","7","12","20","43","0"
"Mitchel Bakker","NED","MF","Atalanta","0.2","1","0","1","0","0","1","1","0","0","0","0","0","0","0"
"Tommaso Baldanzi","ITA","MF,FW","Roma","9.2","12","4","5","4","3","4","12","8","4","0","4","6","8","0"
"Keita Baldé","SEN","FW","Monza","7.1","1","1","0","1","0","1","2","1","4","0","4","2","0","0"
"Botond Balogh","HUN","DF","Parma","22.8","36","16","22","13","1","20","28","8","34","26","8","25","141","2"
"Mario Balotelli","ITA","FW,MF","Genoa","0.7","0","0","0","0","0","0","0","0","0","0","0","0","1","0"
"Lameck Banda","ZAM","FW,MF","Lecce","6.8","8","5","4","2","2","3","12","9","7","0","7","2","8","1"
"Daniel Bandeira","POR","MF","Hellas Verona","4.5","4","0","1","3","0","3","6","3","2","1","1","6","8","0"
"Mattia Bani","ITA","DF","Genoa","16.7","19","10","11","6","2","7","11","4","13","8","5","22","85","2"
"Antonín Barák","CZE","MF","Fiorentina","0.6","2","0","0","2","0","0","2","2","1","1","0","0","0","0"
"Federico Barba","ITA","DF","Como","4.8","2","2","1","1","0","1","4","3","2","2","0","4","15","0"
"Nicolò Barella","ITA","MF","Inter","27.3","50","31","19","20","11","26","59","33","26","3","23","12","16","1"
"Davide Bartesaghi","ITA","DF","Milan","1.3","4","2","1","1","2","4","4","0","1","1","0","3","1","0"
"Federico Baschirotto","ITA","DF","Lecce","38.0","37","25","30","5","2","22","28","6","44","32","12","23","237","2"
"Daniele Baselli","ITA","MF","Como","0.2","0","0","0","0","0","0","0","0","0","0","0","1","1","0"
"Alessandro Bastoni","ITA","DF","Inter","25.9","46","23","26","14","6","20","30","10","25","13","12","21","52","1"
"Reda Belahyane","MAR","MF","Hellas Verona","18.4","36","26","16","13","7","13","17","4","20","9","11","10","22","1"
"Reda Belahyane","MAR","MF","Lazio","2.2","8","6","8","0","0","6","6","0","3","2","1","1","5","0"
"Raoul Bellanova","ITA","DF","Torino","1.0","0","0","0","0","0","0","1","1","0","0","0","0","4","0"
"Raoul Bellanova","ITA","DF","Atalanta","26.7","24","14","8","13","3","13","21","8","12","3","9","18","45","0"
"Andrea Belotti","ITA","FW","Como","6.6","7","5","1","4","2","1","4","3","4","0","4","1","8","0"
"Lucas Beltrán","ARG","FW,MF","Fiorentina","20.7","23","10","10","7","6","7","21","14","15","2","13","5","14","0"
"Adrian Benedyczak","POL","FW,MF","Parma","2.4","0","0","0","0","0","0","1","1","3","1","2","0","8","0"
"Ismaël Bennacer","ALG","MF","Milan","3.3","5","4","1","3","1","1","7","6","5","3","2","3","1","0"
"Medon Berisha","ALB","MF","Lecce","8.0","12","8","7","3","2","4","8","4","6","0","6","11","5","2"
"Adrian Bernabe","ESP","MF","Parma","16.1","29","18","16","9","4","14","32","18","22","9","13","7","26","1"
"Antoine Bernede","FRA","MF","Hellas Verona","6.6","15","8","4","9","2","10","16","6","6","1","5","5","3","0"
"Sam Beukema","NED","DF","Bologna","33.5","54","29","27","24","3","22","41","19","36","21","15","30","111","0"
"Alessandro Bianco","ITA","MF","Monza","28.9","51","28","26","17","8","27","41","14","40","14","26","22","53","4"
"Alessandro Bianco","ITA","MF","Fiorentina","0.2","0","0","0","0","0","0","1","1","0","0","0","0","0","0"
"Jaka Bijol","SVN","DF","Udinese","32.9","43","25","32","10","1","21","40","19","38","18","20","38","182","1"
"Philip Billing","DEN","MF","Napoli","2.2","9","6","4","4","1","1","4","3","4","1","3","4","6","0"
"Cristiano Biraghi","ITA","DF","Torino","12.9","16","10","9","3","4","11","18","7","15","4","11","8","44","0"
"Cristiano Biraghi","ITA","DF","Fiorentina","4.8","4","4","1","3","0","2","7","5","2","0","2","4","11","0"
"Samuele Birindelli","ITA","DF,MF","Monza","16.3","22","15","13","4","5","6","14","8","15","2","13","10","34","2"
"Bjarki Bjarkason","ISL","DF,MF","Venezia","1.8","3","2","2","1","0","1","2","1","1","0","1","2","4","0"
"Emil Bohinen","NOR","MF","Genoa","1.8","4","4","3","0","1","2","5","3","2","0","2","1","6","0"
"Warren Bondo","FRA","MF","Monza","18.0","35","24","19","12","4","13","19","6","16","6","10","5","8","4"
"Warren Bondo","FRA","MF","Milan","1.8","5","3","4","1","0","3","3","0","1","0","1","0","2","0"
"Kevin Bonifazi","ITA","DF","Lecce","0.7","1","1","1","0","0","1","1","0","1","1","0","2","3","0"
"Ange-Yoan Bonny","FRA","FW","Parma","28.1","34","16","4","23","7","8","14","6","17","2","15","3","17","0"
"Edoardo Bove","ITA","MF,FW","Fiorentina","9.3","24","17","7","14","3","14","28","14","12","0","12","6","8","0"
"Domagoj Bradarić","CRO","DF","Hellas Verona","21.5","36","28","21","11","4","18","29","11","17","4","13","15","49","1"
"Matthias Braunöder","AUT","MF","Como","3.0","10","4","6","3","1","7","11","4","3","0","3","2","4","1"
"Iker Bravo","ESP","FW,MF","Udinese","7.6","10","6","3","5","2","5","9","4","4","1","3","1","4","0"
"Gleison Bremer","BRA","DF","Juventus","6.0","15","7","9","5","1","4","5","1","15","11","4","6","16","0"
"Brenner","BRA","MF,FW","Udinese","4.3","6","4","2","3","1","3","8","5","4","0","4","1","6","0"
"Marco Brescianini","ITA","MF","Atalanta","11.0","18","11","5","9","4","8","10","2","15","2","13","2","6","0"
"Arvid Brorsson","SWE","DF","Monza","4.0","4","3","2","2","0","2","5","3","9","8","1","2","35","1"
"Tajon Buchanan","CAN","DF,FW","Inter","1.1","3","0","2","0","1","1","2","1","0","0","0","0","3","0"
"Alessandro Buongiorno","ITA","DF","Napoli","21.4","39","23","26","12","1","24","32","8","30","18","12","35","73","2"
"Rareș-Cătălin Burnete","ROU","FW","Lecce","0.3","0","0","0","0","0","0","1","1","0","0","0","0","0","0"
"Gianluca Busio","USA","MF","Venezia","28.0","46","31","24","12","10","20","47","27","36","8","28","19","52","0"
"Jean Butez","FRA","GK","Como","18.5","0","0","0","0","0","0","2","2","0","0","0","0","18","1"
"Liberato Cacace","NZL","MF,DF","Empoli","24.8","37","25","20","13","4","22","31","9","26","9","17","22","59","0"
"Alessio Cacciamani","ITA","MF,DF","Torino","0.3","0","0","0","0","0","0","0","0","0","0","0","1","0","0"
"Davide Calabria","ITA","DF","Bologna","7.0","12","8","5","5","2","5","12","7","4","0","4","3","22","1"
"Davide Calabria","ITA","DF","Milan","3.5","10","7","10","0","0","4","7","3","1","0","1","8","8","0"
"Luca Caldirola","ITA","DF","Monza","9.7","11","7","8","3","0","4","7","3","9","6","3","11","43","1"
"Hakan Çalhanoğlu","TUR","MF","Inter","20.9","43","22","7","23","13","21","36","15","17","8","9","17","24","0"
"Drissa Camara","CIV","MF,FW","Parma","5.0","9","7","2","6","1","1","10","9","8","0","8","3","1","0"
"Francesco Camarda","ITA","FW,MF","Milan","2.3","5","2","0","2","3","2","6","4","2","1","1","0","3","0"
"Nicolò Cambiaghi","ITA","FW","Bologna","6.9","16","10","6","7","3","5","10","5","9","0","9","2","2","0"
"Andrea Cambiaso","ITA","DF,FW","Juventus","24.7","46","30","27","13","6","27","44","17","24","4","20","16","34","5"
"Thomas Campaniello","ITA","FW","Empoli","0.3","0","0","0","0","0","0","2","2","0","0","0","0","0","0"
"Matteo Cancellieri","ITA","FW,MF","Parma","15.8","26","16","15","9","2","11","32","21","15","1","14","13","30","0"
"Fali Candé","GNB","DF","Venezia","17.0","25","19","14","10","1","16","23","7","21","15","6","15","90","2"
"Antonio Candela","ITA","DF","Venezia","11.2","31","21","13","11","7","18","26","8","7","5","2","8","22","2"
"Gianluca Caprari","ITA","MF,FW","Monza","18.3","19","11","8","8","3","7","14","7","14","0","14","8","2","1"
"Elia Caprile","ITA","GK","Cagliari","18.0","1","0","1","0","0","0","2","2","0","0","0","0","9","1"
"Elia Caprile","ITA","GK","Napoli","3.6","0","0","0","0","0","0","0","0","0","0","0","0","2","0"
"Francesco Caputo","ITA","FW","Empoli","0.1","0","0","0","0","0","0","0","0","0","0","0","0","0","0"
"Maxence Caqueret","FRA","MF","Como","12.1","36","21","14","18","4","20","38","18","15","1","14","7","4","1"
"Andrea Carboni","ITA","DF","Monza","24.3","60","35","39","17","4","35","53","18","31","16","15","27","106","4"
"Franco Carboni","ITA","DF","Venezia","2.5","5","3","5","0","0","5","8","3","1","1","0","0","11","0"
"Marco Carnesecchi","ITA","GK","Atalanta","34.0","0","0","0","0","0","0","0","0","1","0","1","0","26","2"
"Cesare Casadei","ITA","MF","Torino","11.3","12","5","4","8","0","5","10","5","4","2","2","5","26","0"
"Nicolò Casale","ITA","DF","Bologna","10.0","11","5","4","6","1","5","10","5","15","7","8","17","43","3"
"Nicolò Casale","ITA","DF","Lazio","1.5","5","3","4","1","0","0","0","0","4","3","1","1","2","0"
"Federico Cassa","ITA","MF,FW","Atalanta","0.2","0","0","0","0","0","0","0","0","1","0","1","0","0","0"
"Valentín Castellanos","ARG","FW","Lazio","26.5","13","6","2","4","7","1","10","9","18","2","16","6","25","0"
"Santiago Castro","ARG","FW","Bologna","25.5","18","10","4","9","5","6","17","11","13","2","11","3","20","0"
"Gaetano Castrovilli","ITA","MF","Monza","6.6","12","7","10","2","0","4","11","7","8","2","6","2","9","0"
"Gaetano Castrovilli","ITA","MF,FW","Lazio","1.6","5","2","3","1","1","2","4","2","3","0","3","3","1","0"
"Danilo Cataldi","ITA","MF","Fiorentina","19.0","25","16","13","10","2","14","27","13","17","8","9","22","35","0"
"Zeki Çelik","TUR","DF","Roma","25.1","62","37","21","31","10","23","43","20","28","9","19","15","84","3"
"Alberto Cerri","ITA","FW","Como","1.0","0","0","0","0","0","0","0","0","2","0","2","0","1","0"
"Gabriel Charpentier","CGO","FW","Parma","3.0","4","3","2","1","1","3","4","1","3","0","3","0","9","0"
"Walid Cheddira","MAR","FW","Napoli","0.1","0","0","0","0","0","0","0","0","0","0","0","0","0","0"
"Leandro Chichizola","ARG","GK","Parma","1.0","0","0","0","0","0","0","0","0","0","0","0","0","2","0"
"Samuel Chukwueze","NGA","FW,MF","Milan","10.3","17","11","7","6","4","5","19","14","3","0","3","2","9","0"
"Aaron Ciammaglichella","ITA","MF","Torino","0.0","0","0","0","0","0","0","0","0","0","0","0","0","0","0"
"Giuseppe Ciocci","ITA","GK","Cagliari","0.1","0","0","0","0","0","0","0","0","0","0","0","0","0","0"
"Alessandro Circati","AUS","DF","Parma","6.0","7","5","6","1","0","1","2","1","5","4","1","3","42","1"
"Alphadjo Cissè","ITA","FW,MF","Hellas Verona","0.1","0","0","0","0","0","0","0","0","0","0","0","0","0","0"
"Patrick Ciurria","ITA","MF,DF","Monza","12.3","22","14","11","7","4","4","11","7","13","3","10","6","22","0"
"Saúl Coco","EQG","DF","Torino","31.6","46","26","31","14","1","19","30","11","49","31","18","38","157","4"
"Lorenzo Colombo","ITA","FW,MF","Empoli","24.8","31","14","7","16","8","7","21","14","33","2","31","2","16","1"
"Andrea Colpani","ITA","FW,MF","Fiorentina","15.9","15","9","5","7","3","4","12","8","7","0","7","8","10","0"
"Florinel Coman","ROU","FW,MF","Cagliari","2.9","5","3","3","1","1","2","2","0","2","0","2","1","3","0"
"Pietro Comuzzo","ITA","DF","Fiorentina","23.4","43","21","29","11","3","23","29","6","35","22","13","29","113","4"
"Francisco Conceição","POR","FW,MF","Juventus","14.9","23","14","6","9","8","13","30","17","7","0","7","6","6","0"
"Diego Coppola","ITA","DF","Hellas Verona","32.5","66","36","48","14","4","28","40","12","44","24","20","72","194","2"
"Maxwel Cornet","CIV","FW,MF","Genoa","2.7","2","1","1","0","1","0","1","1","1","1","0","2","2","0"
"Joaquín Correa","ARG","FW,MF","Inter","8.1","11","5","4","7","0","4","13","9","3","0","3","0","6","0"
"Alberto costa","POR","DF","Juventus","4.0","14","10","7","5","2","7","9","2","5","1","4","4","14","0"
"Lassana Coulibaly","MLI","MF","Lecce","29.6","48","29","16","28","4","24","61","37","45","12","33","18","46","1"
"Woyo Coulibaly","MLI","DF","Parma","12.0","13","10","9","2","2","5","11","6","19","2","17","8","25","0"
"Bryan Cristante","ITA","MF","Roma","22.7","48","29","18","24","6","15","26","11","20","10","10","19","36","1"
"Domen Črnigoj","SVN","MF","Venezia","1.5","4","2","0","1","3","1","2","1","5","2","3","4","4","0"
"Juan Cuadrado","COL","DF,MF","Atalanta","9.2","19","9","9","6","4","11","23","12","14","2","12","7","9","0"
"Patrick Cutrone","ITA","FW","Como","22.7","16","11","0","10","6","7","14","7","11","0","11","5","7","0"
"Wylan Cyprien","FRA","MF","Parma","0.3","0","0","0","0","0","0","1","1","1","0","1","1","0","0"
"Danilo D'Ambrosio","ITA","DF","Monza","12.2","28","15","17","10","1","14","23","9","12","8","4","15","36","2"
"Lucas Da Cunha","FRA","MF","Como","29.0","45","25","17","19","9","20","39","19","18","3","15","17","30","1"
"Samuel Dahl","SWE","DF,MF","Roma","0.5","2","2","0","2","0","1","2","1","2","0","2","0","0","0"
"Thijs Dallinga","NED","FW","Bologna","12.8","10","5","0","4","6","3","3","0","10","1","9","1","13","1"
"Maat Daniel Caprini","ITA","FW","Fiorentina","0.1","0","0","0","0","0","0","0","0","0","0","0","0","0","0"
"Flavius Daniliuc","AUT","DF","Hellas Verona","11.2","26","21","14","9","3","15","24","9","10","3","7","7","27","0"
"Danilo","BRA","DF","Juventus","6.5","10","4","7","2","1","5","10","5","4","3","1","9","21","1"
"Matteo Darmian","ITA","DF","Inter","19.8","28","17","12","12","4","14","25","11","14","6","8","10","39","0"
"Juan David Cabal","COL","DF","Juventus","5.1","10","4","7","3","0","8","12","4","2","0","2","2","14","1"
"Keinan Davis","ENG","FW","Udinese","11.8","9","4","1","4","4","3","6","3","2","1","1","1","5","0"
"Paweł Dawidowicz","POL","DF,MF","Hellas Verona","20.5","45","24","20","22","3","18","27","9","16","6","10","20","70","2"
"Charles De Ketelaere","BEL","MF,FW","Atalanta","23.0","13","9","2","9","2","4","15","11","14","3","11","3","9","1"
"Mattia De Sciglio","ITA","DF","Empoli","8.5","18","13","10","8","0","14","17","3","10","3","7","8","35","1"
"Lorenzo De Silvestri","ITA","DF","Bologna","11.8","11","6","7","1","3","7","16","9","12","4","8","10","32","0"
"Koni De Winter","BEL","DF","Genoa","23.7","33","19","21","8","4","17","25","8","11","7","4","25","118","3"
"Alessandro Deiola","ITA","MF","Cagliari","15.9","31","20","11","17","3","10","32","22","26","12","14","13","38","0"
"Enrico Del Prato","ITA","DF","Parma","32.7","33","17","24","8","1","19","26","7","69","35","34","19","132","2"
"Fisayo Dele-Bashiru","NGA","MF,FW","Lazio","10.5","10","6","3","3","4","2","6","4","10","2","8","4","5","0"
"Ali Dembélé","FRA","DF","Torino","4.3","9","5","6","3","0","4","4","0","6","2","4","1","11","1"
"Michele Di Gregorio","ITA","GK","Juventus","33.0","0","0","0","0","0","0","0","0","0","0","0","1","14","0"
"Giovanni Di Lorenzo","ITA","DF","Napoli","37.0","66","44","35","25","6","42","65","23","19","6","13","31","85","1"
"Boulaye Dia","SEN","MF,FW","Lazio","24.2","22","10","5","12","5","7","16","9","12","1","11","6","16","1"
"Assane Diao","SEN","FW,MF","Como","13.9","25","14","9","10","6","12","28","16","8","1","7","3","19","0"
"Federico Dimarco","ITA","DF,FW","Inter","23.8","25","14","10","12","3","10","19","9","24","4","20","14","33","2"
"Berat Djimsiti","ALB","DF","Atalanta","29.3","53","33","29","23","1","29","40","11","34","21","13","40","141","2"
"Dodô","BRA","DF","Fiorentina","33.6","44","29","25","11","8","25","49","24","22","5","17","34","58","2"
"Benjamín Domínguez","ARG","FW","Bologna","14.2","18","7","2","11","5","6","20","14","15","1","14","4","7","0"
"Patrick Dorgu","DEN","DF,FW","Lecce","20.4","45","27","21","19","5","23","45","22","24","6","18","18","42","2"
"Alberto Dossena","ITA","DF","Como","20.3","33","20","23","8","2","16","28","12","22","11","11","22","89","1"
"Issa Doumbia","ITA","MF","Venezia","10.4","14","8","6","7","1","7","17","10","17","5","12","9","14","1"
"Anastasios Douvikas","GRE","FW","Como","6.4","3","2","0","3","0","1","4","3","3","0","3","1","3","0"
"Artem Dovbyk","UKR","FW","Roma","26.9","4","2","0","1","3","0","4","4","10","3","7","2","12","0"
"Ondrej Duda","SVK","MF","Hellas Verona","26.6","46","27","21","22","3","29","64","35","28","9","19","31","30","4"
"Denzel Dumfries","NED","DF,FW","Inter","20.7","25","15","12","9","4","14","27","13","31","8","23","6","26","1"
"Alfred Duncan","GHA","MF","Venezia","10.6","17","8","4","11","2","5","14","9","7","2","5","8","8","0"
"Paulo Dybala","ARG","FW,MF","Roma","15.7","17","7","3","9","5","8","19","11","12","1","11","2","2","0"
"Enzo Ebosse","CMR","DF","Udinese","1.0","0","0","0","0","0","0","2","2","3","3","0","1","1","0"
"Tyronne Ebuehi","NGA","DF,MF","Empoli","0.8","3","2","1","2","0","1","1","0","1","0","1","2","0","0"
"Éderson","BRA","MF","Atalanta","32.0","52","32","19","28","5","22","34","12","30","6","24","35","36","1"
"Kingsley Ehizibue","NED","DF","Udinese","27.8","55","35","31","18","6","25","41","16","41","14","27","23","70","5"
"Jeff Ekhator","ITA","FW,MF","Genoa","8.5","7","4","4","1","2","4","9","5","10","1","9","2","5","0"
"Jurgen Ekkelenkamp","NED","MF","Udinese","21.0","36","25","10","22","4","18","35","17","26","4","22","12","26","0"
"Emmanuel Ekong","SWE","MF,FW","Empoli","2.1","4","3","0","2","2","3","3","0","2","1","1","1","1","0"
"Caleb Ekuban","GHA","FW","Genoa","6.2","3","3","1","1","1","1","1","0","4","1","3","1","6","0"
"Mikael Ellertsson","ISL","DF,MF","Venezia","27.4","58","26","37","14","7","33","61","28","42","5","37","17","79","0"
"Elif Elmas","MKD","FW,MF","Torino","11.3","10","7","3","5","2","4","10","6","8","2","6","6","5","2"
"Emerson","BRA","DF","Milan","15.3","45","28","24","16","5","16","34","18","13","2","11","14","56","0"
"Yannik Engelhardt","GER","MF,DF","Como","12.9","30","12","13","13","4","16","27","11","13","6","7","11","27","0"
"Martin Erlic","CRO","DF","Bologna","3.7","2","0","0","2","0","1","2","1","5","4","1","2","9","0"
"Sebastiano Esposito","ITA","FW,MF","Empoli","25.9","57","29","15","31","11","18","35","17","20","2","18","12","14","0"
"Estanis","ESP","FW","Bologna","0.1","0","0","0","0","0","0","0","0","0","0","0","0","0","0"
"Nahuel Estévez","ARG","MF","Parma","7.3","16","6","7","8","1","6","15","9","9","2","7","3","26","0"
"Giovanni Fabbian","ITA","MF","Bologna","11.4","10","6","1","3","6","7","13","6","7","2","5","2","4","0"
"Alieu Fadera","GAM","FW,DF","Como","18.3","64","47","25","27","12","20","45","25","18","1","17","12","10","0"
"Nicolò Fagioli","ITA","MF","Fiorentina","10.7","19","10","8","9","2","9","22","13","11","2","9","5","12","2"
"Nicolò Fagioli","ITA","MF","Juventus","6.3","14","10","7","6","1","6","9","3","4","0","4","2","5","0"
"Wladimiro Falcone","ITA","GK","Lecce","38.0","0","0","0","0","0","0","0","0","0","0","0","0","29","3"
"Davide Faraoni","ITA","DF","Hellas Verona","2.9","10","9","5","5","0","3","9","6","7","3","4","2","12","1"
"Jacopo Fazzini","ITA","MF","Empoli","15.4","32","19","11","16","5","13","23","10","13","1","12","6","24","0"
"Mattia Felici","ITA","MF,FW","Cagliari","10.3","17","12","8","7","2","4","11","7","10","0","10","7","7","1"
"João Félix","POR","MF","Milan","8.4","6","6","3","2","1","4","14","10","2","0","2","1","9","0"
"Lewis Ferguson","SCO","MF","Bologna","10.9","24","13","4","14","6","9","16","7","9","2","7","5","9","0"
"Daniel Fila","CZE","FW","Venezia","5.5","2","0","0","1","1","0","2","2","6","0","6","0","5","0"
"Alessandro Florenzi","ITA","FW","Milan","0.1","0","0","0","0","0","0","0","0","0","0","0","0","0","0"
"Youssouf Fofana","FRA","MF","Milan","27.8","56","34","20","31","5","26","52","26","32","9","23","19","24","3"
"Michael Folorunsho","ITA","FW,MF","Fiorentina","7.2","19","12","9","6","4","8","20","12","9","1","8","4","10","0"
"Michael Folorunsho","ITA","FW,MF","Napoli","0.4","3","2","0","3","0","2","4","2","0","0","0","1","1","1"
"Omari Forson","ENG","MF,FW","Monza","2.5","3","3","1","2","0","1","3","2","3","0","3","1","1","0"
"Davide Frattesi","ITA","MF","Inter","12.9","17","8","6","10","1","10","18","8","12","4","8","5","14","1"
"Morten Frendrup","DEN","MF","Genoa","34.5","102","61","23","52","27","34","78","44","62","16","46","47","57","0"
"Martin Frese","DEN","DF","Hellas Verona","6.1","18","11","7","10","1","7","13","6","5","1","4","8","16","1"
"Remo Freuler","SUI","MF","Bologna","35.6","79","40","28","40","11","33","79","46","38","4","34","38","57","1"
"Matteo Gabbia","ITA","DF","Milan","23.9","21","15","13","7","1","8","10","2","25","19","6","15","103","1"
"Tommaso Gabellini","ITA","FW","Torino","0.1","0","0","0","0","0","0","0","0","0","0","0","0","0","0"
"Tiago Gabriel","POR","DF","Lecce","1.1","0","0","0","0","0","0","0","0","4","2","2","0","11","0"
"Alessandro Gabrielloni","ITA","FW,MF","Como","1.6","0","0","0","0","0","0","3","3","0","0","0","0","1","0"
"Gianluca Gaetano","ITA","MF,FW","Cagliari","11.2","11","8","4","6","1","5","15","10","8","0","8","6","8","0"
"Roberto Gagliardini","ITA","MF,DF","Monza","2.0","3","2","1","2","0","1","4","3","1","0","1","2","4","0"
"Antonino Gallo","ITA","DF","Lecce","29.0","65","42","46","15","4","34","62","28","33","6","27","20","133","0"
"Silvère Ganvoula M'Boussy","CGO","FW","Monza","3.6","0","0","0","0","0","0","1","1","1","0","1","1","5","0"
"Federico Gatti","ITA","DF","Juventus","24.4","28","23","18","8","2","14","24","10","27","18","9","18","76","2"
"David de Gea","ESP","GK","Fiorentina","34.0","1","0","1","0","0","1","1","0","0","0","0","0","12","0"
"Valentin Gendrey","FRA","DF","Lecce","2.0","2","2","1","0","1","1","1","0","3","1","2","2","1","0"
"Daniele Ghilardi","ITA","DF","Hellas Verona","22.5","44","29","27","17","0","25","41","16","29","15","14","30","106","0"
"Lautaro Gianetti","ARG","DF","Udinese","9.8","22","10","16","5","1","14","20","6","20","10","10","15","49","1"
"Samuel Gigot","FRA","DF","Lazio","7.6","4","3","1","3","0","0","1","1","8","6","2","13","36","0"
"Mario Gila","ESP","DF","Lazio","30.5","55","37","35","18","2","37","56","19","20","13","7","28","115","4"
"Billy Gilmour","SCO","MF","Napoli","13.1","24","16","10","9","5","12","20","8","6","1","5","9","23","0"
"Santiago Giménez","MEX","FW","Milan","7.4","5","3","0","4","1","3","4","1","3","1","2","1","13","0"
"Gvidas Gineitis","LTU","MF","Torino","15.9","25","15","8","10","7","13","25","12","16","6","10","18","32","0"
"Ben Godfrey","ENG","DF","Atalanta","0.3","0","0","0","0","0","0","1","1","1","1","0","0","0","0"
"Saba Goglichidze","GEO","DF","Empoli","28.2","64","37","36","25","3","25","51","26","36","17","19","33","97","3"
"Edoardo Goldaniga","ITA","DF","Como","28.1","34","21","21","8","5","13","18","5","21","10","11","33","102","3"
"Pierluigi Gollini","ITA","GK","Genoa","7.0","0","0","0","0","0","0","0","0","1","0","1","0","2","1"
"Nicolás González","ARG","FW,MF","Juventus","19.4","24","13","10","9","5","9","25","16","16","4","12","9","37","2"
"Robin Gosens","GER","DF","Fiorentina","27.0","56","31","31","17","8","25","44","19","34","11","23","18","91","0"
"Lucas Gourna-Douath","FRA","MF","Roma","2.5","9","4","5","4","0","2","6","4","1","1","0","0","2","0"
"Alberto Grassi","ITA","MF","Empoli","24.5","39","21","16","18","5","14","22","8","22","12","10","33","43","1"
"Mattéo Guendouzi","FRA","MF","Lazio","36.3","37","21","13","19","5","20","47","27","34","9","25","32","50","2"
"Frederic Guilbert","FRA","DF","Lecce","27.1","65","36","30","29","6","36","55","19","28","8","20","47","113","3"
"Albert Guðmundsson","ISL","FW,MF","Fiorentina","14.1","9","5","2","4","3","7","17","10","5","0","5","6","9","1"
"Emmanuel Gyasi","GHA","DF,FW","Empoli","35.7","52","29","32","14","6","24","38","14","27","9","18","11","77","0"
"Christian Gytkjær","DEN","FW","Venezia","8.4","6","4","2","2","2","1","2","1","3","1","2","0","8","0"
"Nicolas Haas","SUI","MF","Empoli","3.2","11","8","4","5","2","5","9","4","2","1","1","4","6","0"
"Saad El Haddad","MAR","MF","Venezia","0.3","0","0","0","0","0","0","0","0","0","0","0","0","0","0"
"Antoine Hainaut","FRA","DF,FW","Parma","13.4","26","14","15","8","3","9","13","4","17","4","13","15","59","1"
"Mohamed Haj","TUN","MF","Parma","5.0","3","1","2","1","0","1","2","1","3","1","2","4","5","0"
"Ridgeciano Haps","SUR","DF","Venezia","15.2","30","16","19","8","3","14","22","8","18","3","15","7","48","0"
"Abdou Harroui","NED","MF,FW","Hellas Verona","5.1","9","6","6","3","0","4","4","0","5","0","5","2","5","0"
"Liam Henderson","SCO","MF","Empoli","26.0","42","22","17","22","3","22","53","31","19","5","14","15","42","0"
"Mario Hermoso","ESP","DF","Roma","2.8","2","1","2","0","0","0","1","1","1","1","0","4","13","0"
"Theo Hernández","FRA","DF","Milan","30.0","36","28","23","10","3","21","39","18","25","10","15","17","75","3"
"Hernani","BRA","MF","Parma","14.7","47","26","25","18","4","27","50","23","26","6","20","19","12","1"
"Isak Hien","SWE","DF","Atalanta","25.9","48","28","27","21","0","27","44","17","31","18","13","31","82","2"
"Emil Holm","SWE","DF","Bologna","12.6","34","21","17","14","3","20","31","11","19","4","15","10","51","1"
"Mats Hummels","GER","DF","Roma","10.2","30","15","16","14","0","11","18","7","12","4","8","26","43","0"
"Elseid Hysaj","ALB","DF","Lazio","4.7","11","6","6","5","0","3","3","0","5","2","3","5","21","0"
"Arijon Ibrahimović","GER","MF","Lazio","0.1","0","0","0","0","0","0","0","0","0","0","0","0","0","0"
"Jay Idzes","IDN","DF","Venezia","34.7","45","29","24","17","4","17","33","16","52","32","20","32","156","0"
"Jonathan Ikone","FRA","FW","Como","6.0","15","9","4","3","8","6","11","5","5","1","4","0","1","1"
"Jonathan Ikone","FRA","FW,MF","Fiorentina","3.7","5","2","3","2","0","2","4","2","3","0","3","1","1","0"
"Ivan Ilić","SRB","MF","Torino","10.2","5","2","0","4","1","2","8","6","0","0","0","5","10","0"
"Samuel Iling-Junior","ENG","FW,MF","Bologna","1.3","3","2","1","1","1","0","1","1","1","0","1","2","2","0"
"Alessio Iovine","ITA","DF,FW","Como","4.3","5","2","2","3","0","4","10","6","7","1","6","3","21","1"
"Gustav Isaksen","DEN","FW","Lazio","24.6","16","9","7","8","1","7","28","21","22","2","20","10","21","1"
"Ardian Ismajli","ALB","DF","Empoli","27.9","30","23","21","9","0","16","20","4","35","24","11","56","249","3"
"Armando Izzo","ITA","DF","Monza","27.1","40","15","30","9","1","18","36","18","38","28","10","45","101","0"
"Fellipe Jack","BRA","DF","Como","1.9","9","4","8","1","0","3","5","2","2","2","0","4","5","0"
"Ali Jasim","IRQ","FW,DF","Como","0.1","1","0","1","0","0","1","1","0","0","0","0","0","0","0"
"Gaby Jean","FRA","DF","Lecce","15.4","14","7","8","5","1","6","11","5","13","10","3","9","71","1"
"Juan Jesus","BRA","DF","Napoli","11.9","25","14","16","9","0","12","20","8","15","3","12","9","42","0"
"Alejandro Jiménez","ESP","DF,FW","Milan","14.1","24","13","8","14","2","11","27","16","24","3","21","15","23","0"
"Þórir Jóhann Helgason","ISL","MF","Lecce","12.8","10","7","3","6","1","7","13","6","7","2","5","6","11","2"
"Jesse Joronen","FIN","GK","Venezia","7.8","0","0","0","0","0","0","0","0","0","0","0","0","4","1"
"Luka Jović","SRB","FW,MF","Milan","6.2","0","0","0","0","0","0","0","0","2","1","1","1","3","0"
"Mohamed Kaba","FRA","MF","Lecce","5.0","13","8","7","5","1","8","10","2","11","4","7","4","10","1"
"Christian Kabasele","BEL","DF","Udinese","12.9","17","9","10","7","0","11","14","3","14","8","6","14","75","1"
"Pierre Kalulu","FRA","DF","Juventus","26.0","41","25","29","9","3","18","24","6","27","15","12","17","68","1"
"Hassane Kamara","CIV","DF","Udinese","22.2","35","25","20","11","4","16","28","12","23","5","18","26","49","1"
"Yann Karamoh","FRA","MF,FW","Torino","11.6","5","2","2","1","2","4","9","5","10","2","8","3","5","0"
"Jesper Karlsson","SWE","FW","Bologna","3.3","1","0","0","0","1","0","2","2","4","0","4","0","3","0"
"Jesper Karlsson","SWE","FW","Lecce","5.5","3","2","3","0","0","2","8","6","2","0","2","0","4","0"
"Jesper Karlström","SWE","MF","Udinese","35.4","61","34","32","21","8","25","51","26","28","11","17","35","82","5"
"Lior Kasa","ISR","MF,FW","Genoa","2.6","4","4","2","2","0","2","5","3","4","1","3","3","5","0"
"Grigoris Kastanos","CYP","MF,FW","Hellas Verona","9.7","23","16","8","7","8","9","21","12","17","2","15","7","8","0"
"Michael Kayode","ITA","DF,FW","Fiorentina","1.4","1","1","1","0","0","0","0","0","3","1","2","2","7","0"
"Moise Kean","ITA","FW","Fiorentina","29.1","7","5","1","2","4","3","4","1","12","0","12","5","26","1"
"Mandela Keita","BEL","MF","Parma","20.3","44","25","13","25","6","18","35","17","18","7","11","21","29","2"
"Lloyd Kelly","ENG","DF","Juventus","11.3","15","11","5","9","1","7","9","2","11","6","5","2","56","3"
"Marc-Oliver Kempf","GER","DF","Como","29.1","30","20","15","14","1","13","24","11","35","26","9","33","136","4"
"Kialonda","ANG","DF","Lecce","23.8","34","12","24","10","0","12","17","5","44","28","16","32","132","1"
"Magnus Kofod Andersen","DEN","MF","Venezia","7.7","13","4","3","9","1","4","10","6","7","2","5","6","12","0"
"Sead Kolašinac","BIH","DF","Atalanta","21.1","41","26","21","20","0","16","30","14","16","7","9","25","53","1"
"Randal Kolo Muani","FRA","FW","Juventus","12.9","11","7","3","5","3","4","5","1","8","0","8","4","2","0"
"Ismael Konate","CIV","FW,MF","Empoli","1.3","4","2","4","0","0","2","3","1","3","2","1","0","1","0"
"Manu Koné","FRA","MF","Roma","28.6","41","26","17","17","7","19","40","21","27","4","23","24","28","0"
"Teun Koopmeiners","NED","MF,FW","Juventus","22.2","32","16","6","19","7","10","30","20","36","14","22","8","26","2"
"Odilon Kossounou","CIV","DF","Atalanta","12.5","16","11","8","6","2","6","13","7","16","6","10","13","25","1"
"Christian Kouamé","CIV","FW,MF","Fiorentina","6.9","13","8","4","4","5","0","3","3","3","1","2","2","10","0"
"Christian Kouamé","CIV","FW,MF","Empoli","5.6","5","4","0","3","2","2","4","2","4","2","2","0","4","0"
"Viktor Kovalenko","UKR","MF","Empoli","0.9","2","1","0","2","0","0","1","1","0","0","0","0","0","0"
"Mateusz Kowalski","POL","MF","Parma","0.6","0","0","0","0","0","0","0","0","1","0","1","0","1","0"
"Thomas Kristensen","DEN","DF","Udinese","19.5","31","21","16","11","4","20","32","12","18","13","5","21","80","2"
"Nikola Krstović","MNE","FW","Lecce","34.0","18","9","4","7","7","7","16","9","12","7","5","7","24","0"
"Khvicha Kvaratskhelia","GEO","FW,MF","Napoli","13.1","15","9","4","10","1","4","15","11","13","0","13","4","7","0"
"Giorgos Kyriakopoulos","GRE","DF","Monza","31.6","43","26","20","18","5","30","61","31","28","10","18","23","79","0"
"Mathis Lambourde","FRA","FW,MF","Hellas Verona","1.0","3","1","2","1","0","1","3","2","3","0","3","0","1","0"
"Gianluca Lapadula","PER","FW,MF","Cagliari","3.4","2","0","1","0","1","0","1","1","0","0","0","0","1","0"
"Valentino Lazaro","AUT","DF,FW","Torino","25.6","26","12","10","12","4","15","30","15","28","5","23","11","38","1"
"Darko Lazović","SRB","DF,MF","Hellas Verona","16.2","21","10","5","14","2","11","28","17","19","3","16","11","39","0"
"Manuel Lazzari","ITA","DF","Lazio","15.6","26","16","13","11","2","14","24","10","9","5","4","10","19","0"
"Enzo Le Fée","FRA","MF","Roma","3.5","7","4","5","2","0","2","6","4","9","3","6","5","2","0"
"Nicola Leali","ITA","GK","Genoa","29.0","0","0","0","0","0","0","0","0","0","0","0","0","14","1"
"Rafael Leão","POR","FW","Milan","25.8","16","10","4","8","4","11","29","18","15","1","14","6","4","0"
"Stefan Lekovic","SRB","DF","Monza","4.1","9","4","6","2","1","5","13","8","4","4","0","7","5","0"
"Nunzio Lella","ITA","MF","Venezia","0.1","0","0","0","0","0","0","0","0","0","0","0","0","0","0"
"Giovanni Leoni","ITA","DF","Parma","13.3","14","6","10","4","0","5","10","5","20","11","9","15","63","1"
"Ben Lhassine Kone","CIV","MF","Como","0.6","2","2","1","0","1","2","3","1","0","0","0","1","1","0"
"Mattia Liberali","ITA","MF","Milan","0.7","2","1","0","1","1","2","2","0","0","0","0","0","0","0"
"Karol Linetty","POL","MF","Torino","17.1","39","23","17","19","3","20","41","21","14","5","9","12","31","1"
"Dailon Livramento","CPV","FW,MF","Hellas Verona","10.4","15","11","2","7","6","7","13","6","10","2","8","3","9","0"
"Stanislav Lobotka","SVK","MF","Napoli","29.3","47","30","16","21","10","19","31","12","29","11","18","21","57","1"
"Manuel Locatelli","ITA","MF","Juventus","31.4","72","49","29","35","8","32","56","24","58","20","38","23","77","0"
"Ruben Loftus-Cheek","ENG","MF","Milan","11.5","19","8","6","9","4","6","12","6","3","0","3","3","20","0"
"Ademola Lookman","NGA","MF,FW","Atalanta","25.0","32","15","9","15","8","11","19","8","19","0","19","3","5","1"
"Sandi Lovrić","SVN","MF","Udinese","25.6","46","29","25","17","4","22","44","22","33","5","28","22","27","1"
"Lorenzo Lucca","ITA","FW","Udinese","26.1","10","6","3","2","5","5","11","6","18","1","17","7","27","0"
"Jhon Lucumí","COL","DF","Bologna","29.0","53","30","23","29","1","29","41","12","32","14","18","26","88","7"
"José Luis Palomino","ARG","DF","Cagliari","12.0","27","15","16","9","2","15","21","6","21","11","10","22","46","0"
"Douglas Luiz","BRA","MF","Juventus","5.9","13","8","7","5","1","6","9","3","5","2","3","4","5","0"
"Romelu Lukaku","BEL","FW","Napoli","31.6","4","2","0","2","2","1","4","3","7","2","5","1","17","0"
"Sebastiano Luperto","ITA","DF","Cagliari","36.0","48","27","31","16","1","18","28","10","30","15","15","33","161","1"
"Zito Luvumbo","ANG","FW,MF","Cagliari","17.8","10","6","4","3","3","6","19","13","5","0","5","4","4","0"
"Charalampos Lykogiannis","GRE","DF","Bologna","11.6","23","14","14","8","1","10","20","10","10","5","5","11","41","1"
"Mathias Løvik","NOR","DF,FW","Parma","1.0","1","0","0","1","0","1","3","2","1","1","0","2","3","0"
"Giangiacomo Magnani","ITA","DF","Hellas Verona","11.8","20","15","14","6","0","7","7","0","16","9","7","17","73","1"
"Mike Maignan","FRA","GK","Milan","36.6","0","0","0","0","0","0","1","1","1","0","1","0","19","3"
"Antoine Makoumbou","CGO","MF","Cagliari","23.9","42","23","28","11","3","19","25","6","26","5","21","17","28","0"
"Daniel Maldini","ITA","MF,FW","Monza","14.5","14","6","5","9","0","6","13","7","8","2","6","4","12","2"
"Daniel Maldini","ITA","FW,MF","Atalanta","2.9","2","2","0","1","1","1","2","1","1","0","1","2","3","0"
"Youssef Maleh","MAR","MF","Empoli","16.8","45","23","17","23","5","17","34","17","25","6","19","16","25","0"
"Ruslan Malinovskyi","UKR","MF,FW","Genoa","4.3","12","8","4","7","1","3","6","3","2","0","2","1","4","0"
"Dennis Man","ROU","FW,MF","Parma","22.2","13","6","7","3","3","6","24","18","15","3","12","8","11","0"
"Gianluca Mancini","ITA","DF","Roma","34.9","42","26","22","18","2","20","34","14","22","16","6","35","103","0"
"Christos Mandas","GRE","GK","Lazio","9.0","0","0","0","0","0","0","0","0","0","0","0","0","4","0"
"Rolando Mandragora","ITA","MF","Fiorentina","20.6","23","13","9","12","2","14","31","17","22","7","15","15","54","1"
"Alberto Manzoni","ITA","MF","Atalanta","0.1","0","0","0","0","0","0","0","0","0","0","0","0","0","0"
"Alessandro Marcandalli","ITA","DF","Genoa","0.5","1","0","1","0","0","0","0","0","0","0","0","0","2","0"
"Alessandro Marcandalli","ITA","DF","Venezia","3.9","8","6","6","2","0","3","6","3","6","3","3","2","26","0"
"Filip Marchwiński","POL","MF","Lecce","0.2","0","0","0","0","0","0","0","0","0","0","0","0","0","0"
"Pablo Marí","ESP","DF","Monza","18.1","26","15","14","12","0","11","21","10","24","21","3","37","85","2"
"Pablo Marí","ESP","DF","Fiorentina","12.2","14","9","11","3","0","6","11","5","19","14","5","25","94","0"
"Luca Marianucci","ITA","DF","Empoli","11.9","28","12","17","11","0","11","19","8","16","8","8","19","63","1"
"Mirko Marić","CRO","FW,MF","Monza","1.2","1","0","1","0","0","1","2","1","1","1","0","1","1","0"
"Mirko Marić","CRO","FW","Venezia","4.0","6","3","5","1","0","2","5","3","3","1","2","1","10","0"
"Rafa Marín","ESP","DF","Napoli","1.6","1","0","1","0","0","1","2","1","1","1","0","1","4","0"
"Răzvan Marin","ROU","MF","Cagliari","15.6","22","13","8","11","3","13","25","12","7","0","7","2","20","2"
"Guillermo Maripán","CHI","DF","Torino","26.0","40","23","25","14","1","21","33","12","27","13","14","41","138","1"
"Aarón Martín","ESP","DF","Genoa","34.3","71","47","41","26","4","33","51","18","33","11","22","19","73","1"
"Josep Martinez","ESP","GK","Inter","5.0","0","0","0","0","0","0","0","0","0","0","0","0","0","0"
"Lautaro Martínez","ARG","FW","Inter","27.5","30","16","10","12","8","13","25","12","21","3","18","10","15","0"
"Lucas Martínez Quarta","ARG","DF","Fiorentina","3.9","12","7","9","3","0","8","13","5","5","2","3","3","25","1"
"Kevin Martins","ITA","MF,DF","Monza","2.0","5","4","3","2","0","3","6","3","1","0","1","1","4","1"
"Adam Marušić","MNE","DF","Lazio","26.0","32","20","18","12","2","18","30","12","18","8","10","16","61","0"
"Adam Masina","MAR","DF","Torino","21.3","33","15","22","10","1","23","40","17","28","15","13","27","95","2"
"Patrizio Masini","ITA","MF","Genoa","17.1","54","29","18","26","10","19","40","21","26","8","18","15","37","0"
"Alan Matturro","URU","DF","Genoa","10.0","11","6","6","5","0","3","14","11","10","3","7","14","38","0"
"Andrea Mazza","ITA","GK","Monza","0.1","0","0","0","0","0","0","0","0","0","0","0","0","0","0"
"Luca Mazzitelli","ITA","MF","Como","3.7","9","6","4","5","0","5","7","2","5","2","3","3","10","0"
"Pasquale Mazzocchi","ITA","DF,FW","Napoli","7.8","15","7","7","5","3","8","15","7","5","2","3","5","25","0"
"Samuel Mbangula","BEL","FW","Juventus","7.9","15","10","7","6","2","7","13","6","7","0","7","3","4","0"
"Weston McKennie","USA","MF,DF","Juventus","25.7","33","12","18","11","4","13","22","9","28","8","20","14","37","0"
"Scott McTominay","SCO","MF","Napoli","32.6","43","25","12","27","4","18","36","18","22","5","17","24","51","0"
"Filippo Melegoni","ITA","MF,FW","Genoa","1.0","1","1","1","0","0","0","4","4","0","0","0","0","2","0"
"Alex Meret","ITA","GK","Napoli","33.4","0","0","0","0","0","0","0","0","1","0","1","0","16","0"
"Junior Messias","BRA","MF,FW","Genoa","9.4","13","7","6","6","1","3","10","7","8","2","6","6","20","0"
"Valentin Mihaila","ROU","FW,MF","Parma","14.3","29","15","8","13","8","9","22","13","18","0","18","8","6","0"
"Vanja Milinković-Savić","SRB","GK","Torino","37.0","1","0","1","0","0","1","3","2","0","0","0","0","18","4"
"Yerry Mina","COL","DF","Cagliari","28.5","66","32","43","21","2","40","52","12","59","35","24","37","163","3"
"Juan Miranda","ESP","DF","Bologna","25.3","32","18","11","14","7","14","33","19","21","3","18","23","50","1"
"Fabio Miretti","ITA","MF,FW","Genoa","18.6","28","15","6","14","8","18","33","15","20","1","19","7","13","2"
"Henrikh Mkhitaryan","ARM","MF","Inter","25.9","43","24","17","16","10","20","45","25","29","5","24","16","41","0"
"Rui Modesto","ANG","DF,MF","Udinese","6.8","16","12","4","9","3","7","9","2","10","0","10","8","13","0"
"Lorenzo Montipò","ITA","GK","Hellas Verona","36.0","1","0","1","0","0","1","4","3","0","0","0","0","24","4"
"Álvaro Morata","ESP","FW,MF","Milan","12.2","16","10","5","8","3","5","8","3","7","2","5","5","5","0"
"Alberto Moreno","ESP","DF","Como","19.2","25","11","17","8","0","12","26","14","12","3","9","14","40","2"
"Matias Moreno","ARG","DF","Fiorentina","1.6","8","8","5","3","0","4","4","0","5","1","4","1","9","0"
"Tete Morente","ESP","FW,MF","Lecce","22.5","27","17","10","11","6","10","36","26","16","1","15","14","31","1"
"Nikola Moro","CRO","MF","Bologna","13.4","35","27","7","21","7","22","33","11","18","7","11","13","18","0"
"Daniel Mosquera","COL","FW","Hellas Verona","15.3","11","8","3","5","3","1","15","14","11","1","10","2","10","0"
"Dany Mota","POR","FW,MF","Monza","23.4","13","3","2","3","8","4","8","4","18","1","17","9","27","3"
"Bob Murphy Omoregbe","ITA","MF","Milan","0.0","0","0","0","0","0","0","0","0","0","0","0","0","0","0"
"Yunus Musah","USA","MF,FW","Milan","17.5","27","19","13","9","5","12","17","5","9","1","8","7","9","3"
"Juan Musso","ARG","GK","Atalanta","1.0","0","0","0","0","0","0","0","0","0","0","0","0","0","0"
"Kingstone Mutandwa","ZAM","FW,MF","Cagliari","1.4","0","0","0","0","0","0","0","0","0","0","0","0","0","0"
"Obite N'Dicka","CIV","DF","Roma","38.0","32","26","17","15","0","14","21","7","46","30","16","33","150","2"
"Konan N'dri","CIV","FW,MF","Lecce","3.4","3","3","0","0","3","2","3","1","4","0","4","1","0","0"
"Michel Ndary Adopo","FRA","MF","Cagliari","26.8","55","32","16","31","8","15","29","14","20","5","15","27","25","0"
"Cher Ndour","ITA","MF,DF","Fiorentina","4.5","4","1","2","1","1","2","10","8","5","1","4","2","7","1"
"Dan Ndoye","SUI","FW","Bologna","23.8","26","19","8","8","10","16","28","12","23","0","23","9","4","0"
"Victor Nelsson","DEN","DF","Roma","2.1","5","4","3","1","1","3","5","2","1","0","1","2","9","0"
"David Neres","BRA","FW","Napoli","14.3","21","11","10","4","7","10","15","5","7","0","7","7","4","0"
"Cyril Ngonge","BEL","FW","Napoli","2.4","8","5","4","4","0","4","7","3","3","0","3","2","4","0"
"Hans Nicolussi Caviglia","ITA","MF","Venezia","31.8","47","28","17","22","8","29","64","35","39","12","27","28","55","2"
"Oliver Nielsen","DEN","DF","Lazio","0.4","0","0","0","0","0","0","0","0","1","0","1","1","2","0"
"Eybi Nije","SWE","FW,MF","Torino","4.4","5","1","3","1","1","0","3","3","5","1","4","0","1","0"
"Brooke Norton-Cuffy","ENG","DF,FW","Genoa","8.0","12","7","9","3","0","9","11","2","12","2","10","3","12","0"
"Tijjani Noslin","NED","FW,MF","Lazio","9.6","6","5","2","1","3","1","8","7","15","1","14","1","7","0"
"Adam Obert","SVK","DF","Cagliari","12.0","31","18","12","17","2","16","27","11","19","7","12","23","48","2"
"Jens Odgaard","DEN","MF,FW","Bologna","21.7","20","14","3","12","5","6","21","15","19","2","17","9","12","1"
"Noah Okafor","SUI","FW","Milan","4.6","2","1","0","0","2","0","1","1","1","0","1","2","1","0"
"Noah Okafor","SUI","FW,MF","Napoli","0.4","3","2","3","0","0","2","2","0","0","0","0","0","1","0"
"Yllan Okou","FRA","DF","Hellas Verona","0.0","0","0","0","0","0","0","0","0","1","0","1","0","0","0"
"Maduka Okoye","NGA","GK","Udinese","25.0","0","0","0","0","0","0","0","0","0","0","0","0","12","1"
"Mathías Olivera","URU","DF","Napoli","26.3","63","35","31","25","7","32","53","21","36","12","24","28","74","1"
"Jean Onana","CMR","MF","Genoa","3.4","12","6","2","10","0","5","9","4","6","1","5","4","8","1"
"Jacob Ondrejka","SWE","MF,FW","Parma","4.7","12","6","5","7","0","10","12","2","2","0","2","7","2","0"
"Gaetano Oristanio","ITA","FW,MF","Venezia","25.7","17","13","5","8","4","7","15","8","16","0","16","6","6","1"
"Riccardo Orsolini","ITA","FW","Bologna","20.9","16","13","6","6","4","5","11","6","26","0","26","8","10","1"
"Yordan Osorio","VEN","DF","Parma","1.9","5","3","4","1","0","2","2","0","3","1","2","4","6","1"
"Sebastian Otoa","DEN","DF","Genoa","2.0","1","0","1","0","0","1","2","1","1","1","0","3","14","0"
"Remi Oudin","FRA","MF,FW","Lecce","3.3","3","1","1","1","1","2","4","2","6","2","4","2","1","0"
"Cheick Oumar Conde","GUI","MF","Venezia","1.7","6","5","3","2","1","2","5","3","7","2","5","4","3","0"
"Daniel Oyegoke","ENG","DF","Hellas Verona","1.1","2","2","1","0","1","1","1","0","1","0","1","1","7","0"
"Daniele Padelli","ITA","GK","Udinese","1.0","0","0","0","0","0","0","1","1","0","0","0","0","0","0"
"Simone Pafundi","ITA","MF,DF","Udinese","1.3","3","3","2","0","1","1","4","3","0","0","0","0","1","0"
"Tomás Palacios","ARG","DF","Monza","5.0","11","5","9","2","0","9","13","4","7","2","5","8","17","2"
"Tomás Palacios","ARG","DF","Inter","0.1","0","0","0","0","0","0","0","0","0","0","0","1","0","0"
"Alberto Paleari","ITA","GK","Torino","1.0","0","0","0","0","0","0","0","0","0","0","0","0","2","0"
"Marco Palestra","ITA","DF","Atalanta","2.5","6","4","3","2","1","3","3","0","4","1","3","2","4","0"
"Matteo Palma","GER","DF","Udinese","0.1","0","0","0","0","0","0","0","0","1","1","0","0","1","0"
"Leandro Paredes","ARG","MF","Roma","15.3","26","14","9","12","5","16","32","16","14","5","9","19","33","2"
"Fabiano Parisi","ITA","DF,MF","Fiorentina","11.7","27","17","11","12","4","12","21","9","14","2","12","17","17","0"
"Mario Pašalić","CRO","MF","Atalanta","21.9","26","16","11","13","2","11","26","15","22","7","15","12","28","1"
"Patric","ESP","DF","Lazio","6.7","9","6","6","3","0","6","10","4","3","2","1","3","22","1"
"Rui Patrício","POR","GK","Atalanta","3.0","0","0","0","0","0","0","0","0","0","0","0","0","3","0"
"Benjamin Pavard","FRA","DF","Inter","17.6","29","16","12","12","5","18","25","7","16","12","4","16","52","0"
"Strahinja Pavlović","SRB","DF","Milan","20.7","52","31","32","19","1","29","50","21","17","6","11","16","82","0"
"Leonardo Pavoletti","ITA","FW,MF","Cagliari","4.9","1","0","0","1","0","0","0","0","4","1","3","0","3","0"
"Martín Payero","ARG","MF","Udinese","15.3","24","16","4","14","6","8","16","8","16","2","14","13","13","0"
"Nicolás Paz","ARG","MF,FW","Como","29.9","51","33","18","26","7","24","51","27","49","3","46","21","16","0"
"Marcus Pedersen","NOR","DF","Torino","15.1","13","8","6","6","1","10","16","6","11","2","9","13","34","1"
"Pedro","ESP","FW,MF","Lazio","12.2","19","14","5","9","5","10","21","11","11","0","11","3","3","1"
"Pietro Pellegri","ITA","FW","Empoli","4.6","7","2","0","6","1","2","4","2","2","0","2","0","3","0"
"Lorenzo Pellegrini","ITA","MF","Roma","18.1","24","16","5","13","6","8","19","11","8","1","7","6","22","0"
"Luca Pellegrini","ITA","DF","Lazio","11.9","23","11","11","10","2","17","32","15","10","3","7","19","32","0"
"Mateo Pellegrino","ARG","FW","Parma","8.2","3","2","1","2","0","1","4","3","6","1","5","1","6","0"
"Andy Pelmard","FRA","DF","Lecce","1.4","6","6","5","1","0","4","4","0","1","0","1","0","5","0"
"Sergiu Perciun","MDA","FW,MF","Torino","1.7","2","2","0","0","2","1","4","3","2","0","2","1","2","0"
"Pedro Pereira","POR","DF","Monza","29.6","53","32","30","18","5","35","55","20","26","12","14","21","85","5"
"Gastón Pereiro","URU","MF","Genoa","0.3","1","0","0","1","0","1","1","0","0","0","0","0","1","0"
"Kike Pérez","ESP","MF","Venezia","12.4","41","25","18","12","11","18","44","26","14","2","12","10","15","0"
"Nehuén Pérez","ARG","DF","Udinese","2.0","1","1","0","0","1","0","1","1","2","2","0","1","7","0"
"Simone Perilli","ITA","GK","Hellas Verona","2.0","0","0","0","0","0","0","0","0","0","0","0","0","1","0"
"Mattia Perin","ITA","GK","Juventus","5.0","0","0","0","0","0","0","0","0","0","0","0","0","2","0"
"Máximo Perrone","ARG","MF","Como","20.6","38","27","19","14","5","13","38","25","15","2","13","20","43","0"
"Matteo Pessina","ITA","MF","Monza","9.5","15","4","3","11","1","9","14","5","6","0","6","12","7","0"
"Andrea Petagna","ITA","FW","Monza","3.7","2","1","0","1","1","1","2","1","0","0","0","1","2","0"
"Giuseppe Pezzella","ITA","DF,FW","Empoli","32.0","55","31","28","17","10","29","57","28","32","8","24","15","110","2"
"Roberto Piccoli","ITA","FW","Cagliari","34.7","13","9","2","6","5","3","12","9","12","4","8","3","31","0"
"Nicholas Pierini","ITA","MF","Venezia","0.9","0","0","0","0","0","0","1","1","2","0","2","0","0","0"
"Santiago Pierotti","ARG","FW","Lecce","21.5","46","24","22","18","6","23","51","28","31","5","26","14","32","0"
"Balthazar Pierret","FRA","MF","Lecce","19.1","51","31","25","23","3","13","30","17","19","5","14","19","31","1"
"Andrea Pinamonti","ITA","FW","Genoa","31.7","10","6","0","7","3","2","8","6","16","4","12","1","28","2"
"Nicola Pintus","ITA","DF","Cagliari","0.0","0","0","0","0","0","0","0","0","0","0","0","0","2","0"
"Niccolò Pisilli","ITA","MF","Roma","13.6","24","11","11","8","5","12","22","10","14","3","11","11","16","0"
"Damián Pizarro","CHI","FW,MF","Udinese","0.2","0","0","0","0","0","0","0","0","0","0","0","0","0","0"
"Semuel Pizzignacco","ITA","GK","Monza","8.2","0","0","0","0","0","0","1","1","0","0","0","0","6","0"
"Tommaso Pobega","ITA","MF","Bologna","13.1","33","19","12","15","6","22","30","8","16","4","12","14","16","0"
"Joel Pohjanpalo","FIN","FW","Venezia","17.8","3","3","1","2","0","0","4","4","7","4","3","4","24","0"
"Matteo Politano","ITA","FW,MF","Napoli","31.2","29","15","17","11","1","15","43","28","21","1","20","13","50","1"
"Marin Pongračić","CRO","DF","Fiorentina","14.4","18","13","13","4","1","7","11","4","14","6","8","12","69","2"
"Stefan Posch","AUT","DF","Bologna","7.9","26","15","12","9","5","15","25","10","19","4","15","5","22","0"
"Stefan Posch","AUT","DF","Atalanta","4.3","18","11","7","8","3","8","9","1","5","1","4","4","13","0"
"Matteo Prati","ITA","MF","Cagliari","6.3","10","4","2","7","1","3","11","8","5","2","3","7","10","1"
"Ivan Provedel","ITA","GK","Lazio","29.0","0","0","0","0","0","0","0","0","1","0","1","1","12","3"
"Diego Pugno","ITA","FW","Juventus","0.1","0","0","0","0","0","0","0","0","0","0","0","0","0","0"
"Christian Pulisic","USA","FW,MF","Milan","27.5","43","29","17","14","12","15","37","22","24","2","22","5","13","2"
"Ionuț Radu","ROU","GK","Venezia","15.0","0","0","0","0","0","0","0","0","0","0","0","0","9","0"
"Hamza Rafia","TUN","MF","Lecce","11.8","44","27","14","25","5","15","32","17","7","2","5","4","18","1"
"Antonio Raimondo","ITA","FW,DF","Venezia","1.0","2","1","1","1","0","0","0","0","0","0","0","0","0","1"
"Ylber Ramadani","ALB","MF","Lecce","20.1","51","28","24","27","0","33","52","19","26","9","17","24","26","3"
"Luca Ranieri","ITA","DF","Fiorentina","33.1","42","24","28","12","2","20","25","5","47","32","15","27","154","1"
"Giacomo Raspadori","ITA","FW,MF","Napoli","12.3","18","9","6","10","2","8","12","4","10","2","8","3","13","0"
"Federico Ravaglia","ITA","GK","Bologna","11.7","0","0","0","0","0","0","0","0","0","0","0","0","9","0"
"Ante Rebić","CRO","FW,MF","Lecce","8.8","12","9","5","5","2","3","9","6","7","1","6","2","4","1"
"Tijjani Reijnders","NED","MF","Milan","34.8","26","13","6","14","6","10","26","16","22","4","18","38","28","2"
"Pepe Reina","ESP","GK","Como","11.5","0","0","0","0","0","0","1","1","0","0","0","0","3","2"
"Devyne Rensch","NED","DF","Roma","5.2","17","13","8","8","1","9","10","1","5","3","2","7","12","1"
"Mateo Retegui","ITA","FW","Atalanta","26.5","14","9","0","9","5","3","16","13","7","0","7","4","17","0"
"Samuele Ricci","ITA","MF","Torino","31.4","35","21","15","14","6","18","28","10","23","9","14","25","51","2"
"Amir Richardson","MAR","MF","Fiorentina","11.4","30","13","13","15","2","9","21","12","14","1","13","6","29","1"
"Sergi Roberto","ESP","MF","Como","7.7","14","8","5","5","4","5","7","2","7","1","6","9","14","0"
"Alessio Romagnoli","ITA","DF","Lazio","29.7","48","29","20","26","2","22","27","5","33","17","16","26","118","1"
"Marten de Roon","NED","MF,DF","Atalanta","34.0","74","48","32","38","4","30","66","36","40","7","33","47","67","1"
"Jonas Rouhi","SWE","DF","Juventus","2.3","4","1","1","3","0","0","1","1","2","0","2","3","2","0"
"Nicolò Rovella","ITA","MF","Lazio","30.2","84","50","39","38","7","41","79","38","19","4","15","47","46","3"
"Amir Rrahmani","KVX","DF","Napoli","37.8","39","31","19","19","1","16","25","9","43","26","17","27","179","2"
"Tommaso Rubino","ITA","MF","Fiorentina","0.1","0","0","0","0","0","0","1","1","0","0","0","0","0","0"
"Matteo Ruggeri","ITA","DF","Atalanta","19.5","39","24","15","14","10","25","39","14","30","4","26","22","50","1"
"Stefano Sabelli","ITA","DF","Genoa","22.9","58","31","27","25","6","20","52","32","28","7","21","22","65","0"
"Alexis Saelemaekers","BEL","DF,FW","Roma","15.4","33","20","22","7","4","18","35","17","12","1","11","9","8","1"
"Alexis Saelemaekers","BEL","DF,FW","Milan","1.0","1","1","0","0","1","1","1","0","0","0","0","1","0","0"
"Richie Sagrado","BEL","DF","Venezia","1.6","2","2","1","1","0","1","1","0","1","0","1","3","4","0"
"Marco Sala","ITA","DF","Como","2.9","9","6","5","3","1","5","8","3","2","0","2","1","9","0"
"Marco Sala","ITA","DF","Lecce","0.8","1","0","0","1","0","0","1","1","1","0","1","0","0","0"
"Anass Salah-Eddine","NED","DF","Roma","1.7","1","1","1","0","0","0","0","0","0","0","0","1","2","2"
"Lazar Samardzic","SRB","MF","Atalanta","13.0","21","15","5","7","9","12","25","13","9","1","8","2","6","0"
"Junior Sambia","FRA","DF,FW","Empoli","4.3","14","10","3","6","5","11","11","0","3","0","3","2","5","0"
"Antonio Sanabria","PAR","FW","Torino","14.6","3","3","1","1","1","1","4","3","6","1","5","1","13","0"
"Alexis Sánchez","CHI","FW","Udinese","4.9","3","1","0","2","1","1","7","6","5","0","5","4","1","1"
"Nicola Sansone","ITA","MF,FW","Lecce","0.7","0","0","0","0","0","0","0","0","0","0","0","0","0","0"
"Amin Sarr","SWE","FW","Hellas Verona","21.2","22","12","3","8","11","5","10","5","18","3","15","3","14","0"
"Razvan Sava","ROU","GK","Udinese","12.0","0","0","0","0","0","0","0","0","0","0","0","0","6","2"
"Nicolò Savona","ITA","DF","Juventus","19.2","29","13","19","9","1","13","25","12","12","3","9","11","38","0"
"Saba Sazonov","GEO","DF","Torino","0.0","0","0","0","0","0","0","0","0","1","1","0","0","0","0"
"Giorgio Scalvini","ITA","DF","Atalanta","3.0","8","4","5","3","0","5","9","4","0","0","0","4","7","0"
"Gianluca Scamacca","ITA","FW","Atalanta","0.1","0","0","0","0","0","0","0","0","0","0","0","0","0","0"
"Joël Schingtienne","BEL","DF","Venezia","12.5","27","16","18","7","2","12","19","7","18","9","9","14","25","5"
"Simone Scuffet","ITA","GK","Cagliari","13.0","0","0","0","0","0","0","1","1","0","0","0","0","8","2"
"Simone Scuffet","ITA","GK","Napoli","1.0","0","0","0","0","0","0","0","0","0","0","0","0","2","0"
"Jacopo Seghetti","ITA","GK","Empoli","1.0","0","0","0","0","0","0","0","0","0","0","0","0","0","0"
"Stefano Sensi","ITA","MF","Monza","3.0","8","5","4","4","0","5","6","1","4","2","2","3","3","1"
"Suat Serdar","GER","MF","Hellas Verona","15.3","35","22","12","19","4","10","26","16","19","4","15","8","21","0"
"Stephan El Shaarawy","ITA","DF,MF","Roma","12.2","16","12","4","6","6","6","12","6","4","0","4","10","13","0"
"Alen Sherri","ALB","GK","Cagliari","6.9","1","0","1","0","0","1","2","1","0","0","0","1","1","0"
"Eldor Shomurodov","UZB","FW,MF","Roma","12.2","14","6","2","7","5","3","6","3","10","1","9","3","5","0"
"Benjamin Siegrist","SUI","GK","Genoa","1.7","0","0","0","0","0","0","0","0","0","0","0","1","1","0"
"Marco Silvestri","ITA","GK","Empoli","5.0","0","0","0","0","0","0","2","2","0","0","0","0","3","1"
"Giovanni Simeone","ARG","FW","Napoli","4.7","2","0","0","1","1","1","6","5","9","2","7","1","6","0"
"Łukasz Skorupski","POL","GK","Bologna","26.3","1","0","1","0","0","1","3","2","0","0","0","0","13","2"
"Ivan Smolčić","CRO","DF","Como","7.0","16","9","8","7","1","9","13","4","8","2","6","10","24","0"
"Simon Sohm","SUI","MF","Parma","33.2","28","17","11","13","4","16","35","19","11","3","8","26","36","0"
"Ola Solbakken","NOR","MF,FW","Empoli","8.4","7","4","0","6","1","3","6","3","0","0","0","2","8","0"
"Oumar Solet","FRA","DF","Udinese","18.6","33","19","18","13","2","21","30","9","32","19","13","17","78","4"
"Daniele Sommariva","ITA","GK","Genoa","0.3","0","0","0","0","0","0","0","0","0","0","0","0","1","0"
"Yann Sommer","SUI","GK","Inter","32.0","0","0","0","0","0","0","0","0","0","0","0","0","13","1"
"Borna Sosa","CRO","DF","Torino","13.1","26","19","14","7","5","16","25","9","13","6","7","14","33","0"
"Riccardo Sottil","ITA","FW,MF","Fiorentina","9.3","5","4","3","1","1","3","4","1","1","0","1","4","3","0"
"Riccardo Sottil","ITA","FW,MF","Milan","1.4","1","1","1","0","0","0","0","0","0","0","0","0","0","0"
"Matìas Soulé","ARG","MF,DF","Roma","19.8","26","16","12","7","7","10","23","13","25","3","22","9","25","0"
"Leonardo Spinazzola","ITA","DF,FW","Napoli","16.9","17","10","6","9","2","10","23","13","12","1","11","9","31","1"
"Marco Sportiello","ITA","GK","Milan","1.4","0","0","0","0","0","0","0","0","0","0","0","0","1","0"
"Filip Stankovic","SRB","GK","Venezia","15.2","0","0","0","0","0","0","0","0","0","0","0","0","11","2"
"Petar Stojanović","SVN","MF","Empoli","0.0","0","0","0","0","0","0","0","0","0","0","0","0","0","0"
"Gabriel Strefezza","BRA","FW,MF","Como","29.1","57","39","20","20","17","21","55","34","24","2","22","13","26","0"
"Ibrahim Sulemana","GHA","MF","Atalanta","3.1","9","4","4","5","0","2","8","6","2","0","2","0","1","0"
"Tomáš Suslov","SVK","MF,FW","Hellas Verona","23.1","54","38","23","24","7","23","72","49","30","2","28","18","17","1"
"Zion Suzuki","JPN","GK","Parma","36.8","1","0","1","0","0","1","2","1","0","0","0","0","35","4"
"Marin Šverko","CRO","DF","Venezia","12.4","20","9","14","6","0","10","12","2","10","5","5","16","45","3"
"Mile Svilar","SRB","GK","Roma","38.0","0","0","0","0","0","0","0","0","0","0","0","0","12","2"
"Michael Svoboda","AUT","DF","Venezia","14.6","26","14","19","6","1","8","19","11","19","11","8","22","66","2"
"Adrien Tameze","CMR","MF,DF","Torino","7.2","5","2","2","3","0","1","10","9","8","5","3","10","8","1"
"Mehdi Taremi","IRN","FW","Inter","9.0","7","1","2","2","3","1","4","3","11","2","9","0","11","0"
"Nuno Tavares","POR","DF","Lazio","18.7","28","21","15","8","5","14","34","20","21","3","18","21","44","2"
"Loum Tchaouna","FRA","FW,MF","Lazio","7.3","8","4","2","2","4","3","9","6","5","1","4","4","14","2"
"Jackson Tchatchoua","CMR","DF,MF","Hellas Verona","35.2","50","31","34","13","3","28","43","15","21","9","12","14","75","2"
"Casper Tengstedt","DEN","FW","Hellas Verona","16.9","7","5","0","5","2","4","9","5","5","1","4","4","29","0"
"Filippo Terracciano","ITA","DF,MF","Milan","6.0","9","6","1","6","2","5","10","5","1","0","1","6","11","0"
"Pietro Terracciano","ITA","GK","Fiorentina","3.0","0","0","0","0","0","0","0","0","0","0","0","0","0","0"
"Florian Thauvin","FRA","FW,MF","Udinese","21.7","20","14","9","8","3","10","25","15","6","0","6","7","10","0"
"Malick Thiaw","GER","DF","Milan","20.1","24","17","15","6","3","6","10","4","14","12","2","15","76","1"
"Morten Thorsby","NOR","MF,FW","Genoa","21.1","49","30","19","20","10","17","29","12","22","1","21","5","28","1"
"Khéphren Thuram","FRA","MF","Juventus","25.8","44","21","16","24","4","18","32","14","32","10","22","14","39","2"
"Marcus Thuram","FRA","FW","Inter","24.4","18","8","7","5","6","3","14","11","16","3","13","3","15","0"
"Cheikh Tidiane Niasse","SEN","MF","Hellas Verona","8.4","18","15","6","12","0","10","19","9","17","4","13","17","17","2"
"Rafael Tolói","ITA","DF","Atalanta","5.2","10","5","3","5","2","4","11","7","8","2","6","8","11","0"
"Fikayo Tomori","ENG","DF","Milan","17.7","40","25","21","16","3","17","25","8","17","12","5","20","61","2"
"Luka Topalović","SVN","MF","Inter","0.1","1","1","0","1","0","0","0","0","0","0","0","0","0","0"
"Lorenzo Tosto","ITA","DF","Empoli","0.0","0","0","0","0","0","0","0","0","0","0","0","0","0","0"
"Souleymane Touré","FRA","DF","Udinese","8.1","7","6","4","3","0","4","5","1","15","6","9","9","17","1"
"Stefano Turati","ITA","GK","Monza","29.7","0","0","0","0","0","0","1","1","0","0","0","0","21","2"
"Kacper Urbanski","POL","MF","Bologna","2.7","5","2","4","0","1","4","6","2","5","1","4","2","5","0"
"Kacper Urbanski","POL","MF","Monza","5.6","5","3","1","2","2","4","7","3","7","2","5","2","9","0"
"Lautaro Valenti","ARG","DF","Parma","17.3","17","12","13","3","1","7","9","2","26","13","13","13","94","1"
"Nicolás Valentini","ARG","DF","Hellas Verona","12.5","35","23","22","12","1","20","31","11","15","7","8","15","97","0"
"Emanuele Valeri","ITA","DF","Parma","31.9","51","31","33","15","3","30","61","31","31","10","21","29","103","4"
"Álex Valle","ESP","DF","Como","11.4","26","12","12","12","2","15","21","6","13","2","11","8","42","0"
"Mattia Valoti","ITA","MF","Monza","0.4","3","3","3","0","0","0","2","2","2","0","2","0","2","0"
"Ignace Van Der Brempt","BEL","DF","Como","14.0","40","32","27","10","3","24","33","9","14","5","9","17","34","0"
"Devis Vásquez","COL","GK","Empoli","32.0","0","0","0","0","0","0","0","0","0","0","0","0","21","4"
"Johan Vásquez","MEX","DF","Genoa","33.8","56","31","24","27","5","26","44","18","59","31","28","50","150","1"
"Matías Vecino","URU","MF","Lazio","9.7","13","7","3","9","1","4","18","14","9","3","6","5","15","0"
"Danilo Veiga","POR","DF","Lecce","4.2","8","6","4","4","0","6","13","7","5","0","5","4","14","0"
"Renato Veiga","POR","DF","Juventus","12.1","17","12","7","9","1","9","14","5","17","13","4","19","81","0"
"Lorenzo Venturino","ITA","FW,MF","Genoa","1.9","5","3","4","0","1","3","6","3","3","0","3","0","5","0"
"Simone Verdi","ITA","MF,FW","Como","1.3","2","2","0","1","1","0","2","2","2","0","2","0","2","0"
"Samuele Vignato","ITA","MF","Monza","5.2","6","3","0","4","2","3","7","4","1","0","1","0","6","0"
"Nicolas Viola","ITA","FW,MF","Cagliari","14.1","14","7","6","7","1","1","10","9","5","0","5","3","5","0"
"Mattia Viti","ITA","DF","Empoli","28.6","65","45","42","20","3","34","52","18","41","18","23","48","128","4"
"Vitinha","POR","FW,MF","Genoa","14.8","23","8","12","6","5","11","30","19","14","2","12","12","22","0"
"Dušan Vlahović","SRB","FW","Juventus","19.8","4","2","0","1","3","1","5","4","7","3","4","1","9","3"
"Vanja Vlahović","SRB","FW,MF","Atalanta","0.7","1","1","0","0","1","0","0","0","0","0","0","0","0","0"
"Nikola Vlašić","CRO","MF,FW","Torino","23.5","37","19","11","17","9","12","30","18","15","3","12","9","15","0"
"Alessandro Vogliacco","ITA","DF","Genoa","7.9","15","3","7","7","1","10","12","2","11","7","4","9","20","0"
"Alessandro Vogliacco","ITA","DF","Parma","8.6","5","2","5","0","0","3","5","2","15","10","5","3","37","0"
"Mërgim Vojvoda","KVX","DF","Torino","12.3","18","10","5","9","4","7","14","7","13","3","10","7","24","1"
"Mërgim Vojvoda","KVX","DF","Como","8.0","9","6","5","4","0","7","9","2","7","4","3","3","18","0"
"Stefan de Vrij","NED","DF","Inter","18.2","18","11","12","5","1","9","12","3","19","11","8","22","89","0"
"Kyle Walker","ENG","DF","Milan","7.3","17","9","12","4","1","13","17","4","9","5","4","9","15","1"
"Sebastian Walukiewicz","POL","DF","Torino","18.5","38","20","18","16","4","23","31","8","21","8","13","18","60","0"
"Sebastian Walukiewicz","POL","DF","Empoli","2.0","1","0","1","0","0","0","1","1","3","3","0","1","15","0"
"Timothy Weah","USA","DF,FW","Juventus","18.2","36","19","15","13","8","14","25","11","25","4","21","14","27","2"
"Mateusz Wieteska","POL","DF","Cagliari","2.0","1","0","0","1","0","1","1","0","3","2","1","7","6","0"
"John Yeboah","ECU","FW,MF","Venezia","13.6","6","3","1","3","2","1","10","9","4","0","4","4","2","0"
"Kenan Yıldız","TUR","FW,MF","Juventus","26.7","54","30","13","26","15","18","32","14","25","0","25","5","13","3"
"Mattia Zaccagni","ITA","FW","Lazio","29.8","38","27","13","21","4","16","32","16","19","1","18","29","22","2"
"Nicola Zalewski","POL","DF,FW","Roma","5.9","8","6","3","2","3","2","7","5","7","2","5","4","8","2"
"Nicola Zalewski","POL","DF,MF","Inter","4.8","7","4","3","2","2","4","6","2","5","1","4","2","5","1"
"Andre-Frank Zambo Anguissa","CMR","MF","Napoli","31.7","42","26","8","28","6","15","34","19","24","6","18","35","40","1"
"Francesco Zampano","ITA","DF","Venezia","18.2","31","20","19","10","2","14","31","17","21","1","20","6","29","2"
"Nicolò Zaniolo","ITA","FW","Fiorentina","3.8","3","1","1","2","0","0","4","4","2","1","1","0","2","0"
"Nicolò Zaniolo","ITA","FW,MF","Atalanta","4.0","0","0","0","0","0","0","2","2","0","0","0","1","0","0"
"Alessandro Zanoli","ITA","FW,DF","Genoa","19.0","29","20","11","14","4","10","23","13","20","3","17","12","40","0"
"Duván Zapata","COL","FW","Torino","6.5","7","5","2","0","5","0","3","3","2","1","1","2","7","0"
"Gabriele Zappa","ITA","DF","Cagliari","34.0","40","23","20","17","3","17","34","17","42","22","20","23","93","1"
"Davide Zappacosta","ITA","DF","Atalanta","23.0","26","16","15","5","6","20","39","19","28","6","22","11","32","2"
"Oier Zarraga","ESP","MF","Udinese","10.0","19","13","7","10","2","10","22","12","9","5","4","2","8","0"
"Jordan Zemura","ZIM","DF","Udinese","15.7","31","14","14","12","5","17","29","12","17","4","13","16","41","0"
"Alessio Zerbin","ITA","DF","Venezia","16.9","51","28","30","12","9","29","52","23","28","3","25","15","25","1"
"Alessio Zerbin","ITA","FW,DF","Napoli","0.0","2","1","2","0","0","1","1","0","0","0","0","0","0","0"
"Kevin Zeroli","ITA","MF","Monza","4.4","6","2","3","3","0","0","1","1","6","1","5","2","11","0"
"Kevin Zeroli","ITA","MF","Milan","0.1","1","1","0","1","0","0","0","0","0","0","0","0","0","0"
"Piotr Zieliński","POL","MF","Inter","10.9","14","10","6","7","1","6","13","7","10","5","5","6","13","1"
"Nadir Zortea","ITA","DF,MF","Cagliari","30.1","30","14","16","12","2","14","37","23","11","0","11","19","47","2"
"Szymon Żurkowski","POL","MF","Empoli","1.2","6","4","2","4","0","4","4","0","3","0","3","1","2","0"
"Milan Đurić","BIH","FW","Monza","14.1","1","1","0","1","0","0","3","3","6","0","6","2","17","0"
"Milan Đurić","BIH","FW","Parma","3.0","0","0","0","0","0","0","2","2","3","0","3","0","2","0"
"Keyliane Abdallah","FRA","FW","Marseille","0.0","1","1","1","0","0","1","1","0","0","0","0","0","0","0"
"Yunis Abdelhamid","MAR","DF","Saint-Étienne","11.5","17","11","15","2","0","10","16","6","26","18","8","14","57","1"
"Himad Abdelli","ALG","MF,FW","Angers","31.6","48","32","13","20","15","15","48","33","24","1","23","26","28","2"
"Mohamed Abdelmoneim","EGY","DF","Nice","9.5","21","14","12","6","3","13","22","9","11","5","6","15","56","1"
"Ali Abdi","TUN","DF,MF","Nice","15.5","43","25","18","14","11","28","43","15","20","6","14","20","37","0"
"Matthis Abline","FRA","FW","Nantes","30.8","11","5","2","4","5","3","9","6","15","1","14","4","36","1"
"Abner","BRA","DF","Lyon","12.1","29","20","12","10","7","21","32","11","15","2","13","5","41","0"
"Zakaria Aboukhlal","MAR","MF,FW","Toulouse","21.1","22","13","7","8","7","4","23","19","16","1","15","6","9","0"
"Akor Adams","NGA","FW","Montpellier","11.9","4","3","1","2","1","3","4","1","2","1","1","1","5","1"
"Martin Adeline","FRA","MF","Reims","0.3","1","1","0","1","0","1","2","1","0","0","0","0","2","0"
"Adryelson","BRA","DF","Lyon","0.0","0","0","0","0","0","0","0","0","0","0","0","1","1","0"
"Emmanuel Agbadou","CIV","DF","Reims","14.0","25","17","19","3","3","19","26","7","22","13","9","19","64","1"
"Jeremy Agbonifo","SWE","FW,MF","Lens","3.3","7","6","6","0","1","3","7","4","2","1","1","1","0","1"
"Ruben Aguilar","FRA","DF,MF","Lens","12.5","34","18","17","12","5","24","39","15","25","3","22","13","23","0"
"Naouirou Ahamada","FRA","MF,FW","Rennes","0.6","0","0","0","0","0","0","0","0","0","0","0","2","2","0"
"Jean-Eudes Aholou","CIV","MF","Angers","21.8","56","36","26","20","10","22","48","26","34","14","20","33","32","0"
"Ayman Aiki","FRA","FW,MF","Saint-Étienne","1.4","3","3","1","2","0","1","1","0","1","0","1","1","0","0"
"Ludovic Ajorque","FRA","FW","Brest","27.7","26","19","3","12","11","10","32","22","20","5","15","6","26","0"
"Ümit Akdag","ROU","DF","Toulouse","5.6","8","4","3","4","1","5","12","7","10","8","2","11","19","0"
"Sergio Akieme","ESP","DF","Reims","28.0","34","23","30","3","1","22","36","14","26","9","17","17","97","4"
"Maghnes Akliouche","FRA","FW,MF","Monaco","26.7","51","31","12","24","15","19","41","22","21","0","21","15","13","0"
"Paul Akouokou","CIV","MF","Lyon","0.2","1","0","0","1","0","0","0","0","0","0","0","1","0","1"
"Clément Akpa","CIV","DF","Auxerre","27.6","55","34","36","12","7","31","46","15","38","14","24","42","141","2"
"Chuba Akpom","ENG","FW","Lille","7.1","8","5","0","4","4","2","6","4","9","0","9","0","3","0"
"Mohamed Ali Cho","FRA","FW,MF","Nice","18.0","13","9","4","5","4","4","12","8","17","1","16","5","8","0"
"Jim Allevinah","GAB","FW","Angers","19.4","19","11","6","9","4","5","28","23","10","0","10","12","17","0"
"Thiago Almada","ARG","MF,FW","Lyon","10.6","14","8","7","5","2","7","21","14","2","0","2","7","6","3"
"Jordan Amavi","FRA","DF","Brest","8.8","24","17","10","11","3","15","21","6","10","2","8","7","18","0"
"Kelvin Amian","FRA","DF","Nantes","24.1","55","31","40","14","1","29","35","6","18","11","7","13","85","0"
"Michael Amir Murillo","PAN","DF","Marseille","27.1","49","31","30","13","6","32","46","14","21","8","13","18","70","4"
"Samuel Amo-Ameyaw","ENG","DF,MF","Strasbourg","3.6","5","3","3","2","0","2","9","7","3","0","3","3","2","0"
"Mathis Amougou","FRA","MF","Saint-Étienne","9.5","21","15","15","5","1","10","19","9","10","0","10","12","4","0"
"Benjamin André","FRA","MF","Lille","29.9","103","57","31","60","12","54","96","42","42","6","36","48","56","0"
"Kyllian Antonio","FRA","DF,MF","Lens","1.5","3","2","2","0","1","1","3","2","3","0","3","3","3","1"
"Dennis Appiah","FRA","DF","Saint-Étienne","23.6","71","43","42","22","7","41","71","30","36","8","28","29","89","2"
"Carlens Arcus","HAI","DF","Angers","22.7","52","35","32","15","5","34","56","22","24","4","20","27","83","3"
"Hákon Arnar Haraldsson","ISL","MF,FW","Lille","19.5","36","16","9","17","10","16","33","17","10","2","8","8","6","0"
"Marco Asensio","ESP","FW,MF","Paris S-G","6.9","4","3","1","3","0","0","6","6","1","0","1","0","1","0"
"Lorenz Assignon","TOG","DF,MF","Rennes","26.2","49","27","25","22","2","19","43","24","20","3","17","25","74","0"
"Dehmaine Assoumani","FRA","MF,FW","Nantes","1.1","6","3","0","4","2","4","5","1","1","0","1","1","4","0"
"Valentin Atangana Edoa","FRA","MF","Reims","31.7","69","50","32","30","7","28","38","10","31","15","16","37","64","0"
"Florian Ayé","FRA","FW","Auxerre","6.4","2","2","0","0","2","0","2","2","7","0","7","7","6","0"
"André Ayew","GHA","FW","Le Havre","16.1","18","10","3","7","8","7","13","6","9","2","7","3","21","1"
"Neil El Aynaoui","FRA","MF","Lens","17.6","39","21","18","15","6","12","34","22","34","8","26","30","29","0"
"Shavy Babicka","GAB","MF,FW","Toulouse","13.2","21","12","6","11","4","10","21","11","14","0","14","3","4","3"
"Juma Bah","SLE","DF","Lens","7.6","16","10","6","10","0","5","7","2","10","7","3","17","47","1"
"Theo Bair","CAN","FW","Auxerre","10.4","4","3","1","2","1","0","2","2","6","2","4","3","10","0"
"Mitchel Bakker","NED","FW,DF","Lille","12.7","23","13","6","11","6","10","19","9","10","1","9","12","15","0"
"Darryl Bakola","FRA","DF,MF","Marseille","0.2","1","1","0","1","0","0","0","0","0","0","0","0","0","0"
"Dilane Bakwa","FRA","MF,DF","Strasbourg","27.7","26","14","11","8","7","12","24","12","21","1","20","15","27","0"
"Leonardo Balerdi","ARG","DF","Marseille","25.3","54","39","32","17","5","27","47","20","25","14","11","38","72","4"
"Fodé Ballo-Touré","SEN","DF,MF","Le Havre","6.5","8","7","3","4","1","5","9","4","8","3","5","4","27","0"
"Folarin Balogun","USA","FW","Monaco","6.8","1","1","0","0","1","0","4","4","0","0","0","1","0","0"
"Abdoulaye Bamba","CIV","DF","Angers","16.8","22","12","17","4","1","14","19","5","14","8","6","19","79","0"
"Mohamed Bamba","CIV","MF","Reims","0.1","0","0","0","0","0","0","1","1","2","1","1","0","1","0"
"Valentín Barco","ARG","MF,DF","Strasbourg","12.9","36","22","24","10","2","22","30","8","8","3","5","13","28","1"
"Bradley Barcola","FRA","FW","Paris S-G","24.2","27","17","10","8","9","8","31","23","25","2","23","19","12","0"
"Melvin Bard","FRA","DF,MF","Nice","21.5","53","36","35","13","5","24","42","18","38","13","25","29","60","3"
"Gabriel Bares","SUI","MF,DF","Montpellier","0.6","2","2","2","0","0","1","2","1","0","0","0","1","3","0"
"Téo Barisic","FRA","DF","Lyon","0.0","0","0","0","0","0","0","0","0","0","0","0","0","1","0"
"Dylan Batubinsika","COD","DF","Saint-Étienne","22.4","26","13","19","6","1","13","22","9","23","14","9","39","140","3"
"Haris Belkebla","ALG","MF","Angers","19.9","56","38","38","15","3","26","45","19","30","9","21","35","46","1"
"Yassin Belkhdim","FRA","MF","Angers","16.9","53","27","26","21","6","27","58","31","23","6","17","21","41","1"
"Eliesse Ben Seghir","MAR","MF,FW","Monaco","19.4","31","22","12","12","7","18","32","14","20","0","20","13","4","0"
"Ismaël Bennacer","ALG","MF","Marseille","7.2","21","10","8","12","1","12","18","6","6","0","6","10","2","1"
"Saïd Benrahma","ALG","FW,MF","Lyon","8.2","9","5","4","4","1","3","10","7","6","0","6","3","2","0"
"Nabil Bentaleb","ALG","MF","Lille","3.7","4","3","2","0","2","3","7","4","5","0","5","5","7","2"
"Lucas Beraldo","BRA","DF","Paris S-G","22.3","38","31","30","8","0","23","37","14","16","8","8","21","63","3"
"Maxime Bernauer","FRA","DF","Saint-Étienne","8.5","9","9","5","2","2","5","8","3","7","3","4","5","44","1"
"Dimitry Bertaud","COD","GK","Montpellier","4.0","0","0","0","0","0","0","0","0","0","0","0","0","2","0"
"Mika Biereth","DEN","FW","Monaco","13.6","5","5","0","3","2","3","7","4","11","0","11","4","7","0"
"Emmanuel Biumla","FRA","DF","Angers","14.8","19","12","14","5","0","12","18","6","18","8","10","8","84","1"
"Marco Bizot","NED","GK","Brest","32.0","2","1","2","0","0","1","2","1","0","0","0","0","33","0"
"Ludovic Blas","FRA","MF,FW","Rennes","25.5","38","25","9","12","17","23","42","19","16","2","14","13","11","0"
"Augustine Boakye","GHA","FW,MF","Saint-Étienne","8.1","7","3","3","4","0","3","11","8","5","0","5","6","4","0"
"Mathéo Bodmer","FRA","MF","Le Havre","0.1","0","0","0","0","0","0","0","0","0","0","0","0","1","0"
"Jeremie Boga","CIV","MF,FW","Nice","11.7","10","5","2","5","3","4","8","4","13","0","13","3","2","1"
"Moïse Bombito","CAN","DF","Nice","24.4","37","25","22","12","3","24","35","11","35","19","16","18","121","7"
"Saïmon Bouabré","FRA","MF,FW","Monaco","1.1","1","0","0","1","0","0","3","3","1","0","1","0","0","0"
"Ayyoub Bouaddi","FRA","MF","Lille","12.8","50","31","21","21","8","19","32","13","12","3","9","10","12","1"
"Badredine Bouanani","ALG","MF,FW","Nice","12.2","11","4","4","4","3","6","18","12","16","3","13","11","4","0"
"Benjamin Bouchouari","MAR","MF","Saint-Étienne","19.7","33","27","15","13","5","16","46","30","21","1","20","17","15","2"
"Hicham Boudaoui","ALG","MF","Nice","27.1","76","52","28","37","11","31","53","22","40","11","29","22","45","1"
"Justin Bourgault","FRA","DF","Brest","1.4","2","1","1","1","0","0","0","0","0","0","0","0","1","0"
"Benjamin Bourigeaud","FRA","MF","Rennes","0.9","1","0","0","1","0","0","2","2","2","1","1","2","1","0"
"Bilal Brahimi","ALG","MF","Nice","0.8","0","0","0","0","0","0","0","0","1","0","1","0","2","0"
"Lilian Brassier","FRA","DF","Marseille","8.7","8","6","8","0","0","5","6","1","8","3","5","9","28","2"
"Lilian Brassier","FRA","DF","Rennes","13.7","15","12","11","4","0","9","11","2","17","10","7","22","62","1"
"Anthony Briançon","FRA","DF","Saint-Étienne","0.0","0","0","0","0","0","0","0","0","0","0","0","0","0","0"
"Aurélio Buta","POR","DF","Reims","21.9","37","24","22","11","4","21","42","21","19","5","14","22","59","0"
"Marcin Bułka","POL","GK","Nice","34.0","0","0","0","0","0","0","1","1","0","0","0","0","16","6"
"Rémy Cabella","FRA","FW,MF","Lille","11.2","39","19","16","13","10","19","33","14","10","1","9","8","5","0"
"Mathieu Cafaro","FRA","MF,FW","Saint-Étienne","8.1","10","7","4","4","2","4","15","11","7","1","6","7","3","0"
"Duje Ćaleta-Car","CRO","DF","Lyon","17.6","20","12","11","9","0","10","19","9","33","25","8","17","97","2"
"Issiaga Camara","GUI","MF","Nice","0.2","2","1","0","2","0","0","1","1","0","0","0","3","0","0"
"Lamine Camara","SEN","MF","Monaco","22.8","66","41","22","34","10","26","48","22","30","4","26","31","32","1"
"Mahdi Camara","FRA","MF,FW","Brest","29.5","71","40","16","38","17","24","46","22","40","5","35","33","29","0"
"Ousmane Camara","FRA","DF","Angers","2.8","4","3","3","1","0","1","2","1","1","1","0","0","18","0"
"Axel Camblan","FRA","MF,FW","Brest","0.3","1","1","0","0","1","1","2","1","1","0","1","0","0","0"
"Jaydee Canvot","FRA","DF,MF","Toulouse","12.3","23","11","16","5","2","12","18","6","10","2","8","11","54","1"
"Pierrick Capelle","FRA","MF","Angers","5.4","24","17","10","9","5","9","18","9","4","1","3","11","5","1"
"Gabin Capuano","FRA","FW","Lens","0.1","0","0","0","0","0","0","0","0","0","0","0","0","0","0"
"Maxence Caqueret","FRA","MF","Lyon","6.4","21","11","5","11","5","4","22","18","12","2","10","7","2","0"
"Simon Cara","FRA","MF,FW","Montpellier","0.1","0","0","0","0","0","0","0","0","0","0","0","0","0","0"
"Valentin Carboni","ARG","MF,FW","Marseille","1.1","2","2","0","1","1","0","1","1","1","0","1","1","1","0"
"Irvin Cardona","FRA","FW","Saint-Étienne","11.8","6","5","3","3","0","2","14","12","16","3","13","4","6","2"
"Patrik Carlgren","SWE","GK","Nantes","4.6","0","0","0","0","0","0","0","0","0","0","0","0","0","0"
"Josué Casimir","FRA","FW,MF","Le Havre","22.2","37","26","15","15","7","9","18","9","19","0","19","7","35","1"
"Cristian Cásseres Jr.","VEN","MF","Toulouse","30.0","96","61","41","43","12","46","88","42","35","9","26","42","36","1"
"Jean-Charles Castelletto","CMR","DF,MF","Nantes","29.1","34","17","17","15","2","17","27","10","27","18","9","25","151","0"
"Enzo Caumont","FRA","MF","Angers","0.4","1","1","0","1","0","1","2","1","1","1","0","1","1","0"
"Fabien Centonze","FRA","DF","Nantes","2.9","8","4","5","2","1","4","6","2","4","1","3","2","17","0"
"Brendan Chardonnet","FRA","DF","Brest","26.8","45","33","28","14","3","25","40","15","45","28","17","29","169","2"
"Jhoanner Chávez","ECU","DF,MF","Lens","6.6","9","5","4","4","1","2","7","5","10","1","9","6","13","0"
"Théo Chennahi","FRA","DF","Montpellier","2.0","6","3","3","3","0","4","7","3","3","0","3","2","6","0"
"Sidiki Cherif","FRA","FW","Angers","3.6","5","5","1","3","1","3","4","1","4","1","3","0","0","1"
"Rayan Cherki","FRA","FW,MF","Lyon","22.7","15","12","3","8","4","6","28","22","6","0","6","7","6","0"
"Lucas Chevalier","FRA","GK","Lille","34.0","3","2","3","0","0","3","4","1","0","0","0","0","13","4"
"Pedro Chirivella","ESP","MF","Nantes","26.1","44","29","23","16","5","19","42","23","25","4","21","19","45","0"
"Joris Chotard","FRA","MF","Montpellier","21.0","39","27","17","20","2","20","46","26","28","10","18","19","52","1"
"Djaoui Cissé","FRA","MF","Rennes","12.5","33","18","12","15","6","16","26","10","29","4","25","13","11","1"
"Yoann Cissé","FRA","MF","Auxerre","0.1","0","0","0","0","0","0","0","0","0","0","0","1","0","0"
"Jonathan Clauss","FRA","DF,MF","Nice","25.6","52","35","27","19","6","28","56","28","25","2","23","48","68","3"
"Marcus Coco","FRA","DF","Nantes","10.6","27","21","15","9","3","16","31","15","16","5","11","11","46","0"
"Alois Confais","FRA","MF","Le Havre","0.0","0","0","0","0","0","0","0","0","0","0","0","0","0","0"
"Francis Coquelin","FRA","MF","Nantes","2.5","9","5","5","3","1","3","4","1","3","1","2","6","3","0"
"Derek Cornelius","CAN","DF","Marseille","15.8","24","17","15","8","1","17","22","5","16","10","6","14","51","0"
"Pierre Cornud","FRA","DF","Saint-Étienne","6.4","12","10","6","4","2","8","17","9","9","4","5","9","28","1"
"David Costa","POR","MF,FW","Lens","3.9","2","0","1","1","0","1","4","3","5","1","4","1","0","0"
"Logan Costa","CPV","DF","Toulouse","1.0","2","1","0","2","0","1","1","0","2","2","0","2","4","0"
"Grégoire Coudert","FRA","GK","Brest","2.0","0","0","0","0","0","0","0","0","0","0","0","0","1","0"
"Lasso Coulibaly","CIV","FW,MF","Auxerre","0.5","1","1","0","0","1","0","0","0","0","0","0","0","0","0"
"Mamadou Coulibaly","FRA","MF","Monaco","0.1","1","0","0","1","0","0","0","0","0","0","0","0","0","0"
"Soumaïla Coulibaly","FRA","DF","Brest","4.9","4","2","2","2","0","1","1","0","7","2","5","5","26","0"
"Tanguy Coulibaly","FRA","FW,MF","Montpellier","16.5","32","24","13","15","4","14","33","19","18","2","16","11","3","1"
"Marius Courcoul","FRA","MF,DF","Angers","3.4","5","2","3","2","0","2","5","3","4","0","4","5","9","0"
"Nicolas Cozza","FRA","DF,MF","Nantes","22.8","59","41","35","18","6","31","47","16","25","10","15","25","69","0"
"Charlie Cresswell","ENG","DF","Toulouse","28.8","35","23","19","15","1","28","46","18","44","28","16","28","191","3"
"Kévin Danois","FRA","MF","Auxerre","16.2","49","30","20","22","7","20","46","26","17","3","14","20","20","0"
"Kevin Danso","AUT","DF","Lens","12.0","19","7","12","5","2","12","16","4","25","19","6","20","62","1"
"Dante","BRA","DF","Nice","21.8","32","15","17","13","2","15","29","14","29","14","15","34","74","1"
"Pape Daouda Diongue","SEN","MF,FW","Strasbourg","0.9","2","0","1","1","0","1","2","1","0","0","0","3","2","0"
"Mohamed Daramy","DEN","FW","Reims","0.2","0","0","0","0","0","0","0","0","0","0","0","0","1","0"
"Jonathan David","CAN","FW","Lille","28.4","24","8","3","12","9","9","21","12","13","2","11","7","10","1"
"Zuriko Davitashvili","GEO","FW,MF","Saint-Étienne","30.9","22","14","9","7","6","15","49","34","20","0","20","14","14","0"
"Théo De Percin","MTQ","GK","Auxerre","2.0","0","0","0","0","0","0","1","1","0","0","0","0","3","0"
"Thibault De Smet","BEL","DF","Reims","2.1","6","4","5","1","0","4","4","0","5","3","2","4","12","0"
"Amar Dedić","BIH","DF","Marseille","3.5","5","4","2","2","1","3","10","7","0","0","0","3","12","1"
"Romain Del Castillo","FRA","FW","Brest","14.0","31","22","9","13","9","19","32","13","16","0","16","6","5","0"
"Thomas Delaine","FRA","DF","Strasbourg","0.1","1","1","1","0","0","1","1","0","0","0","0","1","1","0"
"Andy Delort","ALG","FW","Montpellier","6.7","4","3","1","2","1","1","2","1","3","1","2","0","3","0"
"Ousmane Dembélé","FRA","FW","Paris S-G","19.2","11","5","0","7","4","4","12","8","3","0","3","9","2","1"
"Rémy Descamps","FRA","GK","Lyon","1.0","0","0","0","0","0","0","0","0","0","0","0","0","0","0"
"Arthur Desmas","FRA","GK","Le Havre","18.0","0","0","0","0","0","0","1","1","0","0","0","0","9","1"
"Mamadou Diakhon","FRA","FW,MF","Reims","9.5","12","8","4","3","5","9","18","9","5","1","4","4","5","0"
"Bafodé Diakité","FRA","DF","Lille","30.7","31","18","17","11","3","18","26","8","30","17","13","27","99","5"
"Oumar Diakité","CIV","FW","Reims","18.1","20","13","7","8","5","9","19","10","13","2","11","3","9","0"
"Habib Diarra","SEN","MF,FW","Strasbourg","26.1","22","13","6","13","3","8","20","12","22","6","16","13","46","3"
"Krépin Diatta","SEN","DF,FW","Monaco","5.6","18","12","13","2","3","14","24","10","5","1","4","9","12","2"
"Kandet Diawara","GUI","FW","Le Havre","0.0","0","0","0","0","0","0","0","0","1","0","1","0","1","0"
"Mahamadou Diawara","FRA","MF","Le Havre","6.5","20","12","10","8","2","8","13","5","13","6","7","13","11","1"
"Mahamadou Diawara","FRA","MF","Lyon","0.2","1","0","0","1","0","1","3","2","2","0","2","0","0","0"
"Bamba Dieng","SEN","FW","Angers","5.9","4","1","1","2","1","0","2","2","2","0","2","0","3","0"
"Kembo Diliwidi","FRA","DF","Lens","0.0","0","0","0","0","0","0","0","0","0","0","0","0","0","0"
"Sinaly Diomande","CIV","DF","Auxerre","21.6","39","19","20","18","1","28","40","12","37","18","19","30","100","2"
"Lois Diony","FRA","FW","Angers","0.2","0","0","0","0","0","0","0","0","0","0","0","0","0","0"
"Sérigné Diop","SEN","FW","Brest","0.0","1","0","0","1","0","0","0","0","1","0","1","0","0","0"
"Sofiane Diop","FRA","MF,FW","Nice","11.8","23","16","16","3","4","9","22","13","19","2","17","17","7","1"
"Andy Diouf","FRA","MF","Lens","24.7","37","26","10","22","5","16","40","24","24","1","23","15","18","2"
"Yehvann Diouf","SEN","GK","Reims","34.0","2","1","2","0","0","1","3","2","0","0","0","1","22","4"
"Assane Dioussé","SEN","MF","Auxerre","7.4","15","7","9","5","1","5","14","9","6","2","4","12","15","0"
"Álex Domínguez","ESP","GK","Toulouse","0.2","0","0","0","0","0","0","0","0","0","0","0","0","0","0"
"Gianluigi Donnarumma","ITA","GK","Paris S-G","23.2","1","1","1","0","0","1","2","1","0","0","0","0","14","0"
"Sékou Doucoure","FRA","DF","Nantes","0.1","0","0","0","0","0","0","0","0","0","0","0","0","3","0"
"Désiré Doué","FRA","FW,MF","Paris S-G","19.2","48","30","15","19","14","24","51","27","26","0","26","13","7","0"
"Guela Doué","CIV","DF","Strasbourg","30.2","65","45","40","15","10","37","54","17","38","6","32","34","154","1"
"Douglas","BRA","MF","Nantes","25.6","69","42","29","31","9","26","44","18","51","11","40","32","47","0"
"Ismaël Doukouré","FRA","DF,MF","Strasbourg","29.3","40","22","19","18","3","17","25","8","31","14","17","25","102","3"
"Kamory Doumbia","MLI","MF,FW","Brest","14.7","41","29","17","17","7","14","31","17","17","1","16","28","13","1"
"Amidou Doumbouya","FRA","DF","Nice","0.5","1","1","0","0","1","1","1","0","3","1","2","1","1","0"
"Jean-Kevin Duverne","HAI","DF","Nantes","6.0","21","12","13","4","4","15","27","12","10","3","7","8","23","0"
"Stefan Džodić","SRB","DF,MF","Montpellier","2.7","8","5","3","5","0","5","8","3","5","4","1","5","10","1"
"Aron Dønnum","NOR","DF,MF","Toulouse","29.9","56","35","25","24","7","31","55","24","29","4","25","28","37","1"
"Noah Edjouma","FRA","MF,FW","Toulouse","1.9","2","2","0","1","1","1","2","1","1","1","0","2","2","0"
"Jacques Ekomie","GAB","DF,FW","Angers","7.7","22","14","9","10","3","8","12","4","16","5","11","4","14","0"
"Pierre Ekwah Elimby","FRA","MF","Saint-Étienne","28.6","54","33","18","30","6","34","56","22","26","12","14","47","72","1"
"Meschak Elia","COD","FW","Nantes","1.9","7","5","3","2","2","1","1","0","3","0","3","0","2","0"
"Breel Embolo","SUI","FW,MF","Monaco","20.5","22","17","7","7","8","5","16","11","11","0","11","3","10","1"
"Emanuel Emegha","NED","FW","Strasbourg","25.5","6","6","1","2","3","2","6","4","18","5","13","1","30","0"
"Romain Faivre","FRA","MF,FW","Brest","10.0","13","10","4","5","4","5","10","5","8","0","8","4","3","1"
"Khalil Fayad","FRA","MF,FW","Montpellier","11.4","31","16","12","17","2","15","28","13","18","1","17","10","15","1"
"Luiz Felipe","ITA","DF","Marseille","1.4","4","3","3","1","0","1","2","1","3","2","1","3","5","0"
"Zinedine Ferhat","ALG","FW,MF","Angers","9.4","9","7","1","5","3","4","13","9","9","0","9","10","12","0"
"Edimilson Fernandes","SUI","MF,DF","Brest","12.3","9","7","3","6","0","7","13","6","14","6","8","20","38","1"
"Matias Fernandez-Pardo","BEL","FW,MF","Lille","11.8","12","9","3","6","3","6","12","6","9","0","9","3","6","0"
"Jordan Ferri","FRA","MF","Montpellier","19.7","42","23","18","22","2","18","44","26","20","3","17","9","20","0"
"Karol Fila","POL","MF","Strasbourg","0.1","0","0","0","0","0","0","0","0","0","0","0","0","0","0"
"Malick Fofana","BEL","FW","Lyon","17.7","22","11","8","11","3","8","17","9","12","0","12","8","6","0"
"Rayan Fofana","FRA","FW,MF","Lens","0.3","2","2","1","1","0","0","0","0","0","0","0","0","0","0"
"Seko Fofana","CIV","MF","Rennes","9.4","11","7","4","6","1","2","7","5","7","1","6","7","7","0"
"Yahia Fofana","CIV","GK","Angers","33.0","0","0","0","0","0","0","2","2","0","0","0","1","25","2"
"Lamine Fomba","FRA","MF","Saint-Étienne","2.4","8","6","2","5","1","2","7","5","7","1","6","4","5","1"
"Przemysław Frankowski","POL","DF","Lens","15.4","32","21","17","10","5","19","30","11","10","2","8","19","28","0"
"Angelo Fulgini","FRA","MF,FW","Lens","11.6","14","10","6","4","4","6","16","10","11","1","10","2","3","0"
"Kyogo Furuhashi","JPN","FW","Rennes","1.4","2","2","1","1","0","1","1","0","0","0","0","0","0","0"
"Gauthier Gallon","FRA","GK","Rennes","0.5","0","0","0","0","0","0","0","0","0","0","0","0","0","0"
"Ignatius Ganago","CMR","FW,MF","Nantes","2.7","1","1","0","1","0","1","2","1","3","1","2","4","2","0"
"Ulisses Garcia","SUI","DF","Marseille","10.3","14","11","7","5","2","4","14","10","5","1","4","8","18","0"
"Jean-Philippe Gbamin","CIV","MF","Nantes","2.4","2","1","0","2","0","1","4","3","5","2","3","3","2","0"
"Mory Gbane","CIV","DF,MF","Reims","12.5","20","11","16","4","0","13","24","11","12","10","2","18","90","1"
"Yann Gboho","FRA","MF,FW","Toulouse","25.9","31","18","7","15","9","14","35","21","20","0","20","6","4","1"
"Denis Genreau","AUS","MF","Toulouse","2.5","7","5","4","1","2","4","8","4","3","0","3","3","4","0"
"Aleksandr Golovin","RUS","MF,FW","Monaco","12.8","38","24","9","20","9","17","39","22","16","4","12","12","7","0"
"André Gomes","POR","MF","Lille","14.2","27","13","9","11","7","11","31","20","7","1","6","6","11","2"
"Angel Gomes","ENG","MF","Lille","8.2","10","6","4","4","2","2","12","10","0","0","0","0","2","0"
"Carlos Gómez","COL","MF,DF","Rennes","4.2","8","6","3","4","1","3","9","6","6","0","6","2","2","0"
"Mathieu Gorgelin","FRA","GK","Le Havre","16.0","2","2","2","0","0","2","3","1","0","0","0","0","8","2"
"Amine Gouiri","ALG","FW,MF","Marseille","11.6","5","5","0","1","4","2","3","1","9","0","9","1","1","0"
"Amine Gouiri","ALG","MF,FW","Rennes","11.5","9","6","4","4","1","2","8","6","8","0","8","2","5","0"
"Jonathan Gradit","FRA","DF","Lens","23.5","44","23","22","19","3","23","40","17","27","12","15","25","122","2"
"Samuel Grandsir","FRA","MF,FW","Le Havre","0.9","5","5","0","3","2","2","3","1","2","0","2","0","0","0"
"Mason Greenwood","ENG","FW,MF","Marseille","31.2","35","18","10","14","11","16","39","23","7","0","7","12","5","2"
"Albert Grønbaek","DEN","MF,FW","Rennes","9.0","21","11","10","7","4","10","28","18","9","1","8","4","6","0"
"Gabriel Gudmundsson","SWE","DF","Lille","19.8","36","25","15","15","6","23","36","13","19","7","12","17","41","3"
"Axel Gueguin","FRA","FW","Montpellier","0.3","1","1","0","1","0","1","1","0","0","0","0","0","0","0"
"Evann Guessand","CIV","FW,MF","Nice","28.5","44","29","12","15","17","6","14","8","27","3","24","15","16","0"
"Bahereba Guirassy","FRA","FW,MF","Nantes","3.9","12","8","6","3","3","7","13","6","10","0","10","1","4","0"
"Massadio Haïdara","MLI","DF","Brest","18.6","27","16","16","9","2","13","29","16","18","2","16","26","73","0"
"Achraf Hakimi","MAR","DF","Paris S-G","23.0","48","36","18","20","10","27","55","28","25","2","23","31","18","3"
"Florent Hanin","ALG","DF","Angers","29.7","69","48","45","17","7","39","71","32","31","10","21","47","99","2"
"Amine Harit","MAR","MF","Marseille","5.8","8","7","0","6","2","1","2","1","6","0","6","3","1","1"
"Hans Hateboer","NED","DF","Rennes","18.7","31","16","14","12","5","18","36","18","19","6","13","29","64","2"
"Kjetil Haug","NOR","GK","Toulouse","5.5","0","0","0","0","0","0","0","0","0","0","0","0","3","0"
"Luis Henrique","BRA","DF,FW","Marseille","29.0","16","9","7","6","3","9","10","1","15","2","13","10","30","0"
"Lucas Hernández","FRA","DF","Paris S-G","9.7","24","18","13","9","2","14","23","9","12","5","7","7","37","2"
"Ki-Jana Hoever","NED","DF","Auxerre","23.6","51","38","26","16","9","30","54","24","33","3","30","21","70","1"
"Cédric Hountondji","BEN","DF","Angers","3.0","6","4","4","2","0","3","7","4","3","3","0","4","14","0"
"Ilyes Housni","FRA","FW,MF","Le Havre","2.6","7","5","2","3","2","2","4","2","2","0","2","1","2","0"
"Pierre Højbjerg","DEN","MF","Marseille","29.6","64","45","25","32","7","37","69","32","28","4","24","42","33","2"
"Hafiz Ibrahim","NGA","FW","Reims","4.3","3","2","0","1","2","0","5","5","4","2","2","2","6","0"
"George Ilenikhena","NGA","FW","Monaco","8.0","4","2","0","3","1","1","2","1","0","0","0","2","0","0"
"Rareş Ilie","ROU","MF","Nice","0.1","1","1","1","0","0","1","1","0","0","0","0","0","0","0"
"Ismaily","BRA","DF","Lille","10.0","33","17","17","12","4","17","26","9","15","1","14","13","49","0"
"Yanis Issoufou","FRA","MF,FW","Montpellier","0.9","6","4","4","1","1","3","5","2","1","0","1","0","1","0"
"Junya Ito","JPN","FW,MF","Reims","29.9","45","30","19","16","10","17","60","43","33","3","30","13","15","2"
"Jérémy Jacquet","FRA","DF","Rennes","10.3","26","17","11","8","7","14","22","8","9","3","6","27","45","1"
"Ismail Jakobs","SEN","DF","Monaco","2.0","5","5","3","0","2","3","5","2","0","0","0","2","6","0"
"Jordan James","WAL","MF","Rennes","13.1","30","19","8","18","4","16","30","14","14","1","13","14","17","1"
"Malcolm Jeng","SWE","DF","Reims","1.2","0","0","0","0","0","0","0","0","1","0","1","3","10","0"
"John Joe","IRL","MF","Reims","6.1","24","15","11","10","3","7","19","12","11","2","9","6","9","0"
"Karl-Johan Johnsson","SWE","GK","Strasbourg","3.0","0","0","0","0","0","0","1","1","0","0","0","0","3","0"
"Paul Joly","FRA","DF","Auxerre","11.2","49","32","30","17","2","27","45","18","19","1","18","25","32","5"
"Jota","POR","FW,MF","Rennes","3.7","5","2","2","3","0","4","7","3","1","0","1","3","2","0"
"Antoine Joujou","FRA","MF,FW","Le Havre","10.5","16","11","10","4","2","9","15","6","15","3","12","9","19","0"
"Jubal","BRA","DF","Auxerre","29.3","60","39","46","13","1","28","40","12","61","36","25","25","201","1"
"Hamed Junior Traorè","CIV","MF","Auxerre","23.3","41","20","11","17","13","16","54","38","14","0","14","8","11","0"
"Yaya Kader Fofana","MLI","MF,FW","Reims","7.0","17","11","8","5","4","4","12","8","11","2","9","3","2","0"
"Tino Kadewere","ZIM","MF,FW","Nantes","5.7","14","8","5","3","6","6","13","7","3","0","3","6","8","0"
"Arnaud Kalimuendo","FRA","FW,MF","Rennes","28.6","19","12","6","9","4","7","15","8","9","2","7","4","16","1"
"Justin-Noël Kalumba","FRA","FW,MF","Angers","0.3","0","0","0","0","0","0","0","0","0","0","0","1","1","0"
"Warren Kamanzi","NOR","DF,MF","Toulouse","11.4","29","13","12","12","5","14","28","14","7","3","4","9","25","0"
"Glen Kamara","FIN","MF","Rennes","7.4","23","11","10","11","2","11","17","6","7","0","7","7","7","0"
"Noham Kamara","FRA","DF","Paris S-G","0.8","1","1","0","1","0","0","0","0","1","1","0","1","1","0"
"Nordine Kandil","FRA","MF","Strasbourg","0.1","0","0","0","0","0","0","0","0","0","0","0","0","1","0"
"Lee Kang-in","KOR","FW,MF","Paris S-G","18.5","25","17","7","11","7","19","35","16","11","1","10","3","3","1"
"Yassine Kechta","MAR","MF,FW","Le Havre","23.3","60","36","32","21","7","33","78","45","25","2","23","26","32","2"
"Thilo Kehrer","GER","DF","Monaco","26.5","37","23","26","11","0","22","38","16","18","10","8","36","113","1"
"Reda Khadra","GER","MF,FW","Reims","0.9","1","1","1","0","0","0","1","1","0","0","0","0","1","0"
"Wahbi Khazri","TUN","FW,MF","Montpellier","12.4","25","18","5","16","4","8","21","13","13","1","12","5","7","0"
"Abdukodir Khusanov","UZB","DF","Lens","10.8","15","11","9","5","1","7","11","4","17","11","6","26","57","0"
"Presnel Kimpembe","FRA","DF","Paris S-G","0.3","1","0","1","0","0","0","0","0","2","2","0","0","1","0"
"Joshua King","NOR","FW,MF","Toulouse","18.6","11","11","4","4","3","5","12","7","10","3","7","6","19","0"
"Cédric Kipré","CIV","DF","Reims","24.3","42","30","30","11","1","29","39","10","42","27","15","32","162","2"
"Hervé Koffi","BFA","GK","Lens","5.0","1","1","1","0","0","1","1","0","0","0","0","0","5","0"
"Philipp Köhn","SUI","GK","Monaco","19.0","0","0","0","0","0","0","1","1","0","0","0","0","11","2"
"Koka","EGY","FW","Le Havre","9.5","4","1","1","3","0","0","4","4","3","0","3","4","6","1"
"Randal Kolo Muani","FRA","FW","Paris S-G","4.0","4","4","1","1","2","0","2","2","1","0","1","0","5","0"
"Geoffrey Kondogbia","CTA","DF,MF","Marseille","22.4","60","38","31","26","3","27","34","7","23","6","17","22","64","4"
"Abdoul Koné","FRA","DF","Reims","1.5","5","3","4","1","0","3","5","2","2","1","1","1","5","0"
"Amadou Koné","MLI","MF","Reims","14.4","49","32","32","16","1","22","35","13","18","4","14","19","38","2"
"Ismaël Koné","CAN","MF,FW","Marseille","4.0","8","4","3","3","2","3","4","1","4","1","3","4","2","1"
"Ismaël Koné","CAN","MF","Rennes","5.2","9","6","4","4","1","5","7","2","9","2","7","4","5","0"
"Emmanuel Koum Mbondo","FRA","DF","Marseille","0.1","0","0","0","0","0","0","0","0","0","0","0","0","0","0"
"Boubakar Kouyaté","MLI","DF","Montpellier","8.4","22","17","16","6","0","11","19","8","17","11","6","12","54","0"
"Goduine Koyalipou","CTA","FW","Lens","9.8","3","2","0","3","0","1","1","0","4","0","4","1","8","0"
"Sael Kumbedi","FRA","DF","Lyon","10.6","28","14","11","13","4","14","20","6","11","3","8","8","32","1"
"Daler Kuzyaev","RUS","MF","Le Havre","6.3","13","8","7","4","2","2","9","7","7","4","3","9","8","0"
"Khvicha Kvaratskhelia","GEO","FW","Paris S-G","10.2","19","13","4","12","3","13","23","10","7","0","7","2","4","0"
"Rémy Labeau Lascary","GLP","FW,MF","Lens","7.1","16","10","7","6","3","5","11","6","5","0","5","1","7","0"
"Gaëtan Laborde","FRA","FW","Nice","20.3","19","13","9","8","2","9","22","13","16","4","12","6","20","0"
"Alexandre Lacazette","FRA","FW","Lyon","22.8","13","6","3","7","3","5","16","11","13","3","10","8","7","0"
"Younes Lachaab","FRA","MF,FW","Lille","0.1","1","1","0","0","1","1","1","0","0","0","0","1","0","0"
"Alban Lafont","FRA","GK","Nantes","12.0","1","1","1","0","0","1","1","0","2","0","2","0","8","1"
"Kenny Lala","MAD","DF","Brest","29.8","66","42","36","23","7","38","57","19","25","9","16","25","75","2"
"Mohamed Lamine Bayo","GUI","FW","Lille","3.4","1","1","0","0","1","1","1","0","0","0","0","0","4","0"
"Gautier Larsonneur","FRA","GK","Saint-Étienne","34.0","1","0","1","0","0","0","2","2","1","0","1","0","25","1"
"Julien Le Cardinal","FRA","DF","Brest","15.3","27","15","16","8","3","11","16","5","18","14","4","33","75","0"
"Jérémy Le Douaron","FRA","FW","Brest","1.1","1","0","0","0","1","0","1","1","1","0","1","0","0","0"
"Benjamin Lecomte","FRA","GK","Montpellier","30.0","0","0","0","0","0","0","0","0","0","0","0","0","18","2"
"Pierre Lees-Melou","FRA","MF","Brest","17.0","48","33","20","19","9","25","54","29","19","3","16","12","23","0"
"Jordan Lefort","FRA","DF","Angers","34.0","52","30","42","9","1","30","44","14","56","37","19","32","206","3"
"Félix Lemaréchal","FRA","MF,FW","Strasbourg","19.8","35","24","13","17","5","14","29","15","35","4","31","14","19","0"
"Donovan Léon","GUF","GK","Auxerre","32.0","0","0","0","0","0","0","3","3","2","0","2","0","26","1"
"Esteban Lepaul","FRA","FW","Angers","18.1","11","6","2","6","3","4","16","12","15","2","13","4","10","0"
"Johann Lepenant","FRA","MF","Nantes","22.8","68","33","30","27","11","32","71","39","35","3","32","18","25","0"
"Louis Leroux","FRA","MF,DF","Nantes","9.1","25","18","10","12","3","16","22","6","22","2","20","8","19","1"
"Pol Lirola","ESP","DF","Marseille","7.6","13","9","5","8","0","5","13","8","7","2","5","4","12","0"
"Gautier Lloris","FRA","DF","Le Havre","30.8","68","43","52","16","0","38","53","15","33","21","12","34","192","0"
"Bradley Locko","FRA","DF","Brest","1.1","2","2","1","1","0","1","1","0","3","2","1","1","3","0"
"Elysée Logbo","FRA","FW","Le Havre","0.3","0","0","0","0","0","0","0","0","0","0","0","0","0","0"
"Anthony Lopes","POR","GK","Nantes","17.4","1","0","1","0","0","1","1","0","0","0","0","1","7","1"
"Jordan Lotomba","SUI","MF,DF","Nice","0.4","0","0","0","0","0","0","0","0","0","0","0","0","1","0"
"Tom Louchet","FRA","DF,MF","Nice","8.6","27","17","17","5","5","17","23","6","12","4","8","18","20","0"
"Milos Lukovic","SRB","FW,MF","Strasbourg","0.1","0","0","0","0","0","0","0","0","0","0","0","0","0","0"
"Othmane Maamma","MAR","FW,MF","Montpellier","4.0","3","1","2","1","0","1","4","3","4","0","4","1","2","1"
"Deiver Machado","COL","DF,MF","Lens","20.1","36","26","14","14","8","17","30","13","20","4","16","16","34","2"
"Lanroy Machine","FRA","FW","Angers","0.1","0","0","0","0","0","0","0","0","0","0","0","0","0","0"
"Yvann Macon","FRA","DF","Saint-Étienne","8.8","19","11","9","7","3","10","21","11","14","4","10","2","10","1"
"Eros Maddy","NED","DF","Auxerre","0.2","0","0","0","0","0","0","0","0","0","0","0","0","0","0"
"Soungoutou Magassa","FRA","MF","Monaco","11.4","47","25","14","27","6","25","46","21","16","3","13","21","19","1"
"Hugo Magnetti","FRA","MF","Brest","25.8","52","32","21","27","4","23","51","28","20","3","17","18","37","0"
"Frank Magri","CMR","FW,MF","Toulouse","16.8","8","2","1","6","1","3","8","5","16","2","14","4","11","0"
"Ainsley Maitland-Niles","ENG","DF","Lyon","22.1","71","44","30","26","15","48","76","28","28","4","24","25","61","6"
"Radosław Majecki","POL","GK","Monaco","15.0","0","0","0","0","0","0","2","2","0","0","0","0","8","1"
"Hamidou Makalou","MLI","FW,MF","Brest","0.4","0","0","0","0","0","0","0","0","0","0","0","0","0","0"
"Nikola Maksimović","SRB","DF","Montpellier","6.5","9","5","6","3","0","6","7","1","5","4","1","6","30","1"
"Aaron Malouda","FRA","FW","Lille","0.0","0","0","0","0","0","0","0","0","0","0","0","0","0","0"
"Hianga Mananga Mbock","FRA","MF","Brest","0.2","0","0","0","0","0","0","0","0","0","0","0","1","0","0"
"Steve Mandanda","FRA","GK","Rennes","16.5","0","0","0","0","0","0","1","1","0","0","0","0","6","2"
"Aïssa Mandi","ALG","DF","Lille","19.3","31","17","12","15","4","16","22","6","23","11","12","15","54","0"
"Orel Mangala","BEL","MF","Lyon","0.7","1","0","0","0","1","0","1","1","2","0","2","0","1","0"
"Sekou Mara","FRA","FW,MF","Strasbourg","8.5","9","6","0","5","4","3","9","6","11","0","11","3","3","0"
"Marquinhos","BRA","DF","Paris S-G","19.2","30","19","8","16","6","25","33","8","27","15","12","11","64","0"
"Ange Martial Tia","MLI","MF,DF","Reims","1.9","4","3","1","2","1","2","6","4","3","0","3","2","4","0"
"Jonas Martin","FRA","MF","Brest","5.5","13","7","10","2","1","6","11","5","4","1","3","8","12","1"
"Han-Noah Massengo","FRA","MF","Auxerre","11.6","17","11","5","8","4","8","12","4","12","4","8","17","10","2"
"Clinton Mata","ANG","DF","Lyon","26.3","41","29","23","14","4","28","36","8","26","17","9","46","72","3"
"Eliot Matazo","BEL","MF","Monaco","0.8","3","2","0","3","0","0","0","0","0","0","0","1","2","0"
"Nemanja Matić","SRB","MF","Lyon","22.3","42","29","15","21","6","23","41","18","21","9","12","18","31","1"
"Rudy Matondo","FRA","MF","Auxerre","0.7","1","1","1","0","0","0","1","1","0","0","0","0","2","0"
"Azor Matusiwa","NED","MF","Rennes","23.1","64","39","32","30","2","32","43","11","29","10","19","34","52","0"
"Neal Maupay","FRA","FW","Marseille","11.6","9","4","1","6","2","3","6","3","5","0","5","2","0","0"
"Christian Mawissa","FRA","DF","Monaco","16.7","42","29","27","13","2","26","44","18","25","6","19","26","48","1"
"Senny Mayulu","FRA","MF","Paris S-G","9.0","25","16","8","14","3","8","14","6","8","3","5","5","12","0"
"Ethan Mbappé","FRA","MF,FW","Lille","2.5","6","2","3","2","1","0","4","4","6","0","6","1","0","0"
"Ibrahim Mbaye","FRA","FW,MF","Paris S-G","3.8","4","2","1","2","1","3","8","5","2","0","2","2","2","0"
"Mark McKenzie","USA","DF","Toulouse","27.7","52","31","31","20","1","33","45","12","31","18","13","22","141","1"
"Facundo Medina","ARG","DF","Lens","28.3","44","29","22","18","4","24","42","18","30","10","20","32","70","0"
"Henrik Meister","DEN","FW","Rennes","0.7","2","0","0","2","0","0","0","0","4","0","4","1","0","0"
"Bamo Meïté","CIV","DF","Montpellier","4.7","5","3","2","1","2","1","2","1","3","3","0","4","14","3"
"Bamo Meïté","CIV","DF","Marseille","0.3","0","0","0","0","0","0","0","0","0","0","0","0","1","0"
"Mohamed Meité","FRA","FW","Rennes","6.0","2","0","0","2","0","1","1","0","1","0","1","0","5","0"
"Farid El Melali","ALG","FW","Angers","21.0","28","16","15","6","7","13","35","22","19","1","18","16","12","1"
"Nuno Mendes","POR","DF","Paris S-G","18.6","30","19","15","12","3","23","39","16","25","8","17","18","37","2"
"Antoine Mendy","SEN","DF","Nice","9.2","30","21","16","14","0","19","29","10","9","5","4","8","29","1"
"Nampalys Mendy","SEN","MF","Lens","6.5","15","8","4","7","4","6","14","8","8","2","6","9","8","0"
"Gideon Mensah","GHA","DF","Auxerre","25.3","68","45","37","21","10","33","66","33","27","4","23","50","83","0"
"Quentin Merlin","FRA","DF","Marseille","17.7","22","17","12","5","5","9","16","7","20","4","16","14","17","1"
"Rafik Messali","FRA","DF","Toulouse","5.1","15","8","6","6","3","7","8","1","9","1","8","10","12","0"
"Thomas Meunier","BEL","DF","Lille","21.4","53","38","32","15","6","33","49","16","21","8","13","34","64","0"
"Lucas Michal","FRA","FW,MF","Monaco","1.3","5","3","3","2","0","2","4","2","2","0","2","1","2","0"
"Georges Mikautadze","GEO","FW","Lyon","16.1","7","6","1","3","3","3","9","6","11","0","11","4","6","0"
"Igor Miladinović","SRB","FW,MF","Saint-Étienne","0.3","0","0","0","0","0","0","0","0","0","0","0","1","1","0"
"Takumi Minamino","JPN","MF,FW","Monaco","24.8","33","19","7","14","12","15","42","27","26","1","25","10","20","0"
"Lucas Mincarelli","FRA","DF","Montpellier","7.9","17","10","6","9","2","6","13","7","8","5","3","9","27","0"
"Terem Moffi","NGA","FW","Nice","0.6","0","0","0","0","0","0","0","0","0","0","0","0","0","0"
"Mostafa Mohamed","EGY","FW","Nantes","13.9","18","9","6","8","4","4","12","8","10","2","8","10","27","0"
"Florent Mollet","FRA","MF,FW","Nantes","2.7","2","2","1","1","0","1","1","0","2","0","2","1","4","0"
"Diego Moreira","POR","DF,MF","Strasbourg","28.5","44","28","17","19","8","24","50","26","23","4","19","35","65","0"
"Gabriel Moscardo","BRA","MF,DF","Reims","0.9","3","1","2","1","0","1","3","2","3","1","2","0","1","0"
"Yael Mouanga","FRA","DF","Montpellier","10.5","14","8","9","3","2","7","9","2","16","8","8","10","50","0"
"Aimen Moueffek","FRA","MF","Saint-Étienne","11.5","20","12","3","11","6","10","23","13","20","7","13","5","26","1"
"Youssoufa Moukoko","GER","FW,MF","Nice","2.3","3","2","2","1","0","1","2","1","2","0","2","0","0","0"
"Louis Mouton","FRA","MF","Saint-Étienne","11.6","49","25","14","25","10","22","37","15","17","3","14","10","19","0"
"Ngal'Ayel Mukau","COD","MF","Lille","13.2","33","18","9","22","2","17","29","12","14","0","14","15","22","0"
"Marshall Munetsi","ZIM","MF","Reims","18.8","36","18","22","9","5","22","38","16","27","3","24","17","35","0"
"Almoatasem Al Musrati","LBY","MF","Monaco","4.3","14","11","5","8","1","7","11","4","3","1","2","5","9","0"
"Junior Mwanga","FRA","MF","Le Havre","10.6","26","16","10","13","3","11","19","8","10","3","7","8","18","2"
"Junior Mwanga","FRA","MF","Strasbourg","3.3","17","9","9","7","1","5","9","4","2","0","2","2","2","0"
"Loïc N'Gatta","FRA","DF","Auxerre","0.1","1","1","0","1","0","1","2","1","1","0","1","0","1","0"
"Djylian N'Guessan","FRA","FW","Saint-Étienne","2.0","6","4","5","1","0","2","5","3","1","0","1","0","1","0"
"Mickael Nade","FRA","DF","Saint-Étienne","25.6","59","43","40","19","0","28","36","8","37","19","18","33","132","8"
"Bilal Nadir","MAR","MF","Marseille","4.3","10","3","4","6","0","4","6","2","6","1","5","4","7","0"
"Mahamadou Nagida","CMR","DF","Rennes","4.8","8","6","4","3","1","4","5","1","3","0","3","9","6","0"
"Keito Nakamura","JPN","FW,MF","Reims","29.4","24","16","7","10","7","11","31","20","21","1","20","13","19","0"
"Sebastian Nanasi","SWE","MF,FW","Strasbourg","23.4","20","13","6","12","2","8","22","14","24","3","21","7","18","0"
"Yael Nandjou","FRA","DF","Nice","1.7","4","1","2","1","1","4","8","4","4","1","3","4","7","0"
"Youssouf Ndayishimiye","BDI","DF","Nice","21.5","40","21","25","14","1","16","27","11","35","19","16","21","117","4"
"Junior Ndiaye","FRA","FW","Montpellier","4.9","3","2","2","1","0","1","4","3","2","1","1","0","2","0"
"Rassoul Ndiaye","SEN","MF","Le Havre","11.8","35","25","19","12","4","11","25","14","15","4","11","12","24","0"
"Wilfried Ndollo","CMR","DF","Montpellier","4.5","6","5","4","1","1","4","8","4","9","1","8","7","11","0"
"Tanguy Ndombele","FRA","MF","Nice","12.6","35","23","10","21","4","12","20","8","9","0","9","14","9","0"
"Loïc Nego","HUN","DF,FW","Le Havre","27.3","58","35","37","16","5","41","64","23","17","3","14","29","82","0"
"João Neves","POR","MF,DF","Paris S-G","20.5","63","31","20","26","17","27","45","18","29","9","20","23","22","1"
"Mikayil Ngor Faye","SEN","DF","Rennes","7.6","15","12","10","3","2","7","9","2","9","4","5","12","30","0"
"Steve Ngoura","FRA","FW","Le Havre","3.2","4","2","1","1","2","3","3","0","2","1","1","0","2","0"
"Bernard Nguene","CMR","FW","Nice","0.1","0","0","0","0","0","0","0","0","0","0","0","0","0","0"
"Moussa Niakhate","SEN","DF","Lyon","30.3","47","27","37","8","2","24","32","8","26","17","9","25","143","3"
"Abdoulaye Niakhate Ndiaye","SEN","DF","Brest","19.0","49","33","36","12","1","25","37","12","29","17","12","11","144","3"
"Ibrahima Niane","SEN","FW","Angers","10.5","7","3","3","2","2","3","3","0","6","1","5","2","6","2"
"Rasmus Nicolaisen","DEN","DF","Toulouse","6.9","6","3","4","2","0","3","5","2","10","5","5","10","25","0"
"Arnaud Nordin","FRA","FW","Montpellier","13.0","24","15","6","16","2","11","21","10","12","0","12","5","7","0"
"Plamedi Nsingi",NA,"MF","Nantes","0.2","1","0","1","0","0","0","1","1","0","0","0","0","0","0"
"Ernest Nuamah","GHA","FW,MF","Lyon","11.7","21","11","15","4","2","12","27","15","9","1","8","8","8","1"
"Rabby Nzingoula","CGO","MF","Montpellier","18.8","64","42","26","31","7","27","58","31","27","5","22","29","23","0"
"M'Bala Nzola","ANG","FW","Lens","16.2","5","4","0","1","4","3","9","6","9","1","8","5","7","0"
"Marwann Nzuzi","FRA","DF","Saint-Étienne","1.4","2","2","1","0","1","1","2","1","0","0","0","2","6","0"
"Hamzat Ojediran","NGA","MF,FW","Lens","4.6","28","15","12","13","3","7","19","12","10","2","8","10","7","0"
"Joseph Okumu","KEN","DF","Reims","18.8","30","15","21","9","0","15","24","9","33","21","12","25","137","2"
"Kazeem Olaigbe","BEL","MF,FW","Rennes","3.3","6","4","3","3","0","3","6","3","3","1","2","0","0","0"
"Ben Old","NZL","FW,MF","Saint-Étienne","5.9","7","5","3","3","1","3","11","8","8","1","7","2","2","0"
"Warmed Omari","COM","DF","Lyon","0.1","0","0","0","0","0","0","0","0","0","0","0","0","1","0"
"Becir Omeragic","SUI","DF","Montpellier","20.0","32","16","19","12","1","16","21","5","32","21","11","13","78","0"
"Andrew Omobamidele","IRL","DF","Strasbourg","6.0","7","4","4","3","0","2","5","3","12","8","4","8","41","0"
"Ado Onaiwu","JPN","MF,FW","Auxerre","10.6","11","7","2","6","3","4","14","10","12","0","12","3","12","0"
"Christopher Operi","CIV","DF,FW","Le Havre","13.0","13","9","6","2","5","7","12","5","20","6","14","14","30","0"
"Fredrik Oppegard","NOR","DF","Auxerre","3.0","6","4","4","1","1","3","7","4","2","1","1","2","12","1"
"Victor Orakpo","NGA","FW","Nice","0.4","0","0","0","0","0","0","0","0","0","0","0","0","0","0"
"Ike Orazi","IRL","MF","Reims","0.0","0","0","0","0","0","0","0","0","0","0","0","0","0","0"
"Gift Orban","NGA","FW,DF","Lyon","2.1","0","0","0","0","0","0","1","1","0","0","0","0","0","0"
"Gabriel Osho","NGA","DF","Auxerre","18.4","23","15","17","3","3","13","20","7","32","19","13","12","87","0"
"Jibril Othman","TUN","FW","Saint-Étienne","0.1","0","0","0","0","0","0","0","0","0","0","0","0","0","0"
"Guimissongui Ouattara","FRA","DF,FW","Strasbourg","5.2","6","4","3","1","2","3","5","2","10","0","10","9","12","2"
"Kassoum Ouattara","FRA","DF,FW","Monaco","4.3","9","7","5","4","0","4","14","10","6","0","6","5","2","1"
"Zinédine Ould Khaled","FRA","MF","Angers","3.8","9","7","5","3","1","2","13","11","6","1","5","2","12","0"
"Beres Owusu","FRA","DF","Saint-Étienne","1.0","2","2","1","1","0","2","2","0","2","2","0","0","5","0"
"Elisha Owusu","GHA","MF","Auxerre","26.0","73","41","29","39","5","31","48","17","33","9","24","42","35","1"
"Willian Pacho","ECU","DF","Paris S-G","23.7","56","32","34","22","0","23","32","9","35","22","13","40","91","1"
"Nicolas Pallois","FRA","DF","Nantes","22.4","61","27","44","13","4","37","63","26","48","18","30","28","164","3"
"Nicolas Pays","FRA","FW,MF","Montpellier","5.0","13","6","3","4","6","4","8","4","1","0","1","4","2","0"
"Kévin Pedro","FRA","DF","Saint-Étienne","0.1","3","0","2","1","0","3","3","0","1","0","1","2","1","0"
"Jordan Pefok","USA","FW","Reims","4.2","3","2","0","3","0","2","3","1","3","1","2","2","5","0"
"Théo Pellenard","FRA","DF","Auxerre","0.5","3","2","2","1","0","1","3","2","1","0","1","0","3","0"
"Timothee Pembele","FRA","DF","Le Havre","12.4","30","22","17","9","4","14","23","9","16","5","11","11","42","0"
"Faris Pemi Moumbagna","CMR","FW","Marseille","0.1","0","0","0","0","0","0","0","0","0","0","0","0","0","0"
"Óscar Perea","COL","MF,DF","Strasbourg","0.2","0","0","0","0","0","0","0","0","0","0","0","0","0","0"
"Mathias Pereira Lage","POR","FW,MF","Brest","17.5","37","24","16","13","8","18","39","21","17","2","15","20","20","2"
"Lucas Perri","BRA","GK","Lyon","33.0","1","1","1","0","0","0","4","4","1","0","1","0","22","1"
"Gaëtan Perrin","FRA","MF,FW","Auxerre","29.9","49","26","22","12","15","21","48","27","10","0","10","12","4","1"
"Prosper Peter","NGA","MF,FW","Angers","0.3","2","1","0","2","0","0","0","0","0","0","0","0","0","0"
"Léo Pétrot","FRA","DF","Saint-Étienne","29.3","62","39","38","19","5","34","51","17","50","27","23","42","103","1"
"Đorđe Petrović","SRB","GK","Strasbourg","31.0","1","1","1","0","0","0","0","0","0","0","0","0","24","1"
"Tom Pouilly","FRA","DF,MF","Lens","3.0","9","6","5","1","3","5","10","5","5","1","4","4","11","0"
"Adrien Rabiot","FRA","MF","Marseille","27.6","49","31","17","21","11","19","32","13","21","2","19","21","32","0"
"Gonçalo Ramos","POR","FW","Paris S-G","11.8","11","6","5","5","1","3","6","3","5","1","4","0","5","0"
"Lilian Raolisoa","FRA","DF,FW","Angers","14.6","41","24","24","13","4","17","38","21","11","2","9","15","45","0"
"Rayan Raveloson","MAD","MF,DF","Auxerre","8.0","6","5","2","4","0","5","15","10","8","7","1","5","22","0"
"Guillaume Restes","FRA","GK","Toulouse","28.3","2","1","2","0","0","2","3","1","0","0","0","1","16","1"
"Alexsandro Ribeiro","BRA","DF","Lille","30.0","32","19","18","13","1","20","30","10","23","13","10","27","143","3"
"Alejandro Rodriguez","POR","MF","Lyon","0.2","0","0","0","0","0","0","0","0","0","0","0","0","0","0"
"Valentin Rongier","FRA","MF,DF","Marseille","17.4","50","28","14","31","5","27","43","16","30","9","21","33","28","5"
"Pablo Rosario","DOM","MF,DF","Nice","19.7","30","20","6","19","5","11","20","9","19","11","8","31","43","2"
"Anthony Rouault","FRA","DF","Rennes","10.8","12","8","10","2","0","4","4","0","13","11","2","8","65","0"
"Jon Rowe","ENG","FW,MF","Marseille","9.0","15","11","5","4","6","6","14","8","4","1","3","2","4","0"
"Fabián Ruiz Peña","ESP","MF","Paris S-G","21.4","37","24","13","15","9","21","47","26","25","3","22","16","27","1"
"Gerónimo Rulli","ARG","GK","Marseille","34.0","4","3","4","0","0","4","8","4","1","0","1","1","25","3"
"Mathew Ryan","AUS","GK","Lens","14.0","1","0","1","0","0","1","2","1","0","0","0","1","2","2"
"Emmanuel Sabbi","USA","FW,MF","Le Havre","7.3","14","7","7","4","3","5","8","3","2","0","2","3","4","0"
"Falaye Sacko","MLI","DF","Montpellier","13.7","14","8","9","4","1","9","19","10","17","7","10","13","21","0"
"Matvei Safonov","RUS","GK","Paris S-G","9.8","0","0","0","0","0","0","0","0","1","0","1","1","3","0"
"Modibo Sagnan","MLI","DF","Montpellier","23.8","57","35","38","16","3","26","44","18","24","13","11","29","110","5"
"Osame Sahraoui","MAR","FW,MF","Lille","14.4","13","9","4","4","5","3","8","5","14","1","13","7","8","1"
"Wesley Saïd","FRA","FW","Lens","10.1","16","11","3","10","3","6","13","7","6","0","6","2","2","0"
"Théo Sainte-Luce","FRA","DF","Montpellier","11.3","24","11","16","4","4","16","33","17","16","4","12","12","33","1"
"Ibrahim Salah","MAR","FW","Brest","4.0","4","2","1","1","2","1","6","5","2","0","2","2","0","0"
"Amine Salama","FRA","FW","Reims","4.1","3","2","0","2","1","0","3","3","2","1","1","1","0","0"
"Mohammed Salisu","GHA","DF","Monaco","11.4","28","18","16","11","1","13","16","3","10","8","2","16","54","2"
"Yoann Salmier","GUF","DF","Le Havre","8.9","14","7","9","4","1","10","13","3","12","8","4","10","59","0"
"Mama Samba Baldé","GNB","FW","Lyon","0.4","2","2","0","2","0","0","0","0","0","0","0","1","1","0"
"Mama Samba Baldé","GNB","FW","Brest","12.8","13","9","4","4","5","3","14","11","8","0","8","6","14","0"
"Brice Samba","FRA","GK","Rennes","17.0","2","1","2","0","0","1","2","1","0","0","0","0","12","3"
"Brice Samba","FRA","GK","Lens","15.0","0","0","0","0","0","0","0","0","0","0","0","1","6","2"
"Arouna Sangante","SEN","DF","Le Havre","13.8","25","16","11","14","0","10","17","7","11","5","6","21","65","3"
"Nhoa Sangui","FRA","DF,MF","Reims","12.9","16","9","6","6","4","9","12","3","8","4","4","8","23","0"
"Morgan Sanson","FRA","MF","Nice","2.6","6","3","2","4","0","1","3","2","3","0","3","4","2","0"
"Baptiste Santamaria","FRA","MF","Nice","10.3","20","10","10","7","3","13","22","9","14","3","11","18","19","1"
"Baptiste Santamaria","FRA","MF","Rennes","5.4","11","4","7","3","1","6","11","5","10","4","6","12","7","0"
"Andrey Santos","BRA","MF","Strasbourg","31.7","110","74","47","51","12","51","87","36","46","14","32","32","67","1"
"Tiago Santos","POR","DF","Lille","4.5","12","7","4","5","3","6","9","3","2","0","2","2","4","0"
"Malang Sarr","FRA","DF","Lens","15.4","21","13","12","6","3","16","27","11","18","9","9","22","63","3"
"Mamadou Sarr","FRA","DF","Strasbourg","26.3","37","21","24","11","2","16","24","8","26","20","6","25","117","3"
"Martin Satriano","URU","FW,DF","Lens","1.0","3","1","1","1","1","3","3","0","0","0","0","0","2","0"
"Téji Savanier","FRA","MF","Montpellier","26.3","29","25","7","16","6","18","43","25","16","1","15","15","21","4"
"Niklas Schmidt","GER","MF","Toulouse","2.3","6","4","1","5","0","4","7","3","0","0","0","1","4","0"
"Jérémy Sebas","MTQ","FW,MF","Strasbourg","2.1","3","2","1","1","1","2","3","1","2","0","2","0","4","0"
"Alidu Seidu","GHA","DF","Rennes","8.9","22","18","14","6","2","12","15","3","13","6","7","14","17","0"
"Hiroki Sekine","JPN","DF","Reims","9.9","9","7","6","2","1","7","17","10","22","11","11","5","51","1"
"Marvin Senaya","TOG","DF","Strasbourg","2.5","8","3","5","2","1","6","12","6","6","2","4","7","12","0"
"Djibril Sidibé","FRA","DF","Toulouse","23.3","65","36","34","22","9","31","50","19","11","3","8","20","64","1"
"Vincent Sierro","SUI","MF","Toulouse","26.7","44","27","15","23","6","27","56","29","34","9","25","16","44","1"
"Caio Henrique Oliveira Silva","BRA","DF","Monaco","21.4","37","26","16","19","2","23","44","21","26","8","18","22","59","0"
"Abdallah Sima","SEN","FW,MF","Brest","13.8","15","11","2","5","8","4","11","7","9","1","8","1","9","0"
"Moses Simon","NGA","FW,MF","Nantes","29.0","20","14","4","7","9","7","22","15","11","0","11","12","13","0"
"Lassine Sinayoko","MLI","FW,MF","Auxerre","25.5","33","20","10","14","9","11","23","12","16","2","14","13","38","0"
"Wilfried Singo","CIV","DF","Monaco","23.3","37","23","24","10","3","20","28","8","17","9","8","43","110","2"
"Ayanda Sishuba","BEL","FW","Rennes","0.0","1","0","1","0","0","1","1","0","0","0","0","0","0","0"
"Ibrahim Sissoko","MLI","FW","Saint-Étienne","9.1","11","9","5","3","3","2","5","3","10","2","8","2","13","0"
"Niama Sissoko","MLI","FW,MF","Reims","0.5","0","0","0","0","0","0","0","0","1","0","1","0","0","0"
"Leo Skiri Østigård","NOR","DF","Rennes","13.6","20","18","16","4","0","15","22","7","12","10","2","15","81","1"
"Milan Škriniar","SVK","DF","Paris S-G","4.2","7","5","3","4","0","3","3","0","7","6","1","3","16","0"
"Naatan Skyttä","FIN","FW","Toulouse","0.1","1","0","0","0","1","0","0","0","0","0","0","0","0","0"
"Eduard Sobol","UKR","DF","Strasbourg","1.1","0","0","0","0","0","0","2","2","2","1","1","2","14","0"
"Florian Sotoca","FRA","FW,MF","Lens","19.9","22","13","3","8","11","12","22","10","12","2","10","14","25","0"
"Issa Soumaré","SEN","FW,MF","Le Havre","21.1","25","14","8","10","7","13","49","36","19","4","15","16","32","0"
"Saidou Sow","GUI","DF","Strasbourg","11.3","9","5","6","3","0","6","12","6","15","9","6","15","37","2"
"Saidou Sow","GUI","DF","Nantes","8.9","17","11","13","4","0","6","10","4","19","12","7","13","46","1"
"Lucas Stassin","BEL","FW","Saint-Étienne","21.0","16","11","3","5","8","6","20","14","10","0","10","3","8","0"
"Enzo Sternal","FRA","FW,MF","Marseille","0.3","0","0","0","0","0","0","0","0","0","0","0","0","0","0"
"Gabriel Suazo","CHI","DF","Toulouse","24.0","59","39","25","22","12","30","72","42","27","3","24","36","40","1"
"Abakar Sylla","CIV","DF","Strasbourg","10.6","27","15","14","11","2","15","17","2","18","10","8","11","63","0"
"Issiaga Sylla","GUI","DF","Montpellier","12.8","25","10","17","7","1","15","29","14","13","4","9","10","34","1"
"Musa Al-Taamari","JOR","FW,MF","Montpellier","12.4","14","10","4","5","5","8","15","7","2","0","2","3","3","2"
"Musa Al-Taamari","JOR","FW,MF","Rennes","6.3","4","1","1","1","2","0","4","4","5","0","5","2","2","0"
"Nicolás Tagliafico","ARG","DF","Lyon","21.1","57","37","24","22","11","29","48","19","25","7","18","36","55","0"
"Axel Tapé","FRA","DF,MF","Paris S-G","2.0","3","1","1","2","0","2","2","0","2","2","0","1","5","0"
"Florian Tardieu","FRA","MF","Saint-Étienne","13.9","18","14","6","9","3","6","17","11","18","5","13","15","21","0"
"Oussama Targhalline","MAR","MF","Le Havre","11.0","19","14","12","3","4","5","12","7","14","7","7","19","14","2"
"Enzo Tchato","CMR","DF","Montpellier","21.1","48","26","26","18","4","26","44","18","30","10","20","22","59","0"
"Arnau Tenas","ESP","GK","Paris S-G","1.0","0","0","0","0","0","0","0","0","0","0","0","0","0","0"
"Tanner Tessmann","USA","MF","Lyon","13.7","25","15","11","10","4","12","25","13","13","7","6","19","29","1"
"Teddy Teuma","MLT","MF","Reims","8.3","18","10","6","6","6","7","25","18","12","2","10","12","8","1"
"Jordan Teze","NED","DF","Monaco","6.3","18","9","8","9","1","7","16","9","12","1","11","6","15","0"
"Sorba Thomas","WAL","FW,MF","Nantes","14.7","14","6","7","5","2","10","18","8","12","2","10","9","27","1"
"Adrien Thomasson","FRA","MF","Lens","29.1","90","47","42","25","23","52","95","43","48","3","45","19","28","2"
"Corentin Tolisso","FRA","MF","Lyon","25.9","57","25","21","26","10","34","65","31","52","13","39","22","41","1"
"Abdoulaye Touré","GUI","MF","Le Havre","25.8","61","34","31","21","9","33","59","26","36","19","17","34","42","5"
"Birama Touré","MLI","MF,DF","Montpellier","3.3","8","5","5","2","1","4","6","2","3","2","1","6","7","0"
"Ousmane Toure","FRA","DF","Lille","0.1","0","0","0","0","0","0","0","0","0","0","0","1","2","0"
"Adrien Truffert","FRA","DF,MF","Rennes","30.6","61","36","27","21","13","32","48","16","44","6","38","27","56","1"
"Vanderson","BRA","DF","Monaco","22.9","76","48","37","30","9","45","64","19","43","6","37","39","65","2"
"Robinio Vaz","FRA","FW","Marseille","0.8","1","1","0","0","1","0","2","2","0","0","0","0","2","0"
"Jordan Veretout","FRA","MF","Lyon","17.3","30","14","14","14","2","17","40","23","17","3","14","5","23","1"
"Ben Viadere","FRA","MF","Auxerre","0.1","0","0","0","0","0","0","0","0","0","0","0","0","0","0"
"Vitinha","POR","MF","Paris S-G","22.7","43","23","13","27","3","25","48","23","26","7","19","14","19","2"
"Ibrahima Wadji","SEN","FW,MF","Saint-Étienne","3.9","7","6","3","3","1","3","7","4","1","0","1","1","0","0"
"Elye Wahi","FRA","FW","Marseille","6.4","0","0","0","0","0","0","4","4","1","0","1","1","0","0"
"Caleb Wiley","USA","DF,MF","Strasbourg","3.0","1","0","0","1","0","0","1","1","3","1","2","4","5","0"
"Christopher Wooh","CMR","DF","Rennes","16.2","36","19","21","13","2","18","27","9","22","8","14","23","63","0"
"Etienne Youte Kinkoue","FRA","DF","Le Havre","25.8","19","10","11","7","1","13","20","7","36","23","13","29","158","3"
"Eloge Zabi","CIV","DF,MF","Reims","0.2","0","0","0","0","0","0","0","0","0","0","0","0","1","0"
"Yoram Zague","FRA","DF,FW","Paris S-G","2.0","8","6","3","1","4","6","8","2","3","0","3","2","2","0"
"Wilfried Zaha","CIV","FW","Lyon","0.8","1","1","1","0","0","1","2","1","3","0","3","1","0","0"
"Warren Zaïre-Emery","FRA","MF,DF","Paris S-G","22.8","51","26","17","21","13","23","45","22","35","6","29","23","20","2"
"Miha Zajc","SVN","MF","Toulouse","2.9","4","4","1","2","1","3","5","2","2","1","1","3","7","0"
"Denis Zakaria","SUI","MF","Monaco","23.8","41","26","15","19","7","24","33","9","31","8","23","34","39","1"
"Anass Zaroury","MAR","FW,MF","Lens","15.6","23","17","6","12","5","9","26","17","9","0","9","6","15","0"
"Nathan Zeze","FRA","DF","Nantes","16.8","38","22","22","16","0","23","33","10","22","9","13","23","120","1"
"Edon Zhegrova","KVX","FW,MF","Lille","10.9","5","2","3","0","2","2","7","5","8","0","8","4","1","0"
"Melvin Zinga","FRA","GK","Angers","1.0","0","0","0","0","0","0","0","0","0","0","0","0","1","0"
"Luck Zogbé","CIV","DF","Brest","7.1","32","18","17","11","4","18","26","8","11","2","9","14","22","1"
"Aristide Zossou","CIV","MF","Auxerre","0.2","0","0","0","0","0","0","0","0","0","0","0","0","0","0"
"Yanis Zouaoui","ALG","DF,FW","Le Havre","10.8","20","10","10","8","2","11","15","4","15","2","13","8","43","0"
"Edhy Zuliani","FRA","DF","Toulouse","0.1","0","0","0","0","0","0","0","0","0","0","0","1","0","0"
